#CHR	POS	Count_A	Count_C	Count_G	Count_T	Good_depth
2R	669894	0	0	0	0	0
2R	927745	0	7	0	22	29
2R	927747	0	4	0	26	30
2R	927763	0	4	0	26	30
2R	927764	0	8	0	22	30
2R	927773	0	14	0	16	30
2R	928819	0	57	0	24	81
2R	928861	0	8	0	73	81
2R	928866	0	41	0	38	79
2R	928867	0	10	0	72	82
2R	946817	0	2	0	20	22
2R	947223	0	1	0	6	7
2R	948265	0	3	0	3	6
2R	949521	0	4	0	3	7
2R	1268441	3	0	1	0	4
2R	1271549	0	0	0	0	0
2R	1362581	0	0	0	0	0
2R	1397455	0	0	0	0	0
2R	1424437	1	0	0	0	1
2R	1424453	1	0	0	0	1
2R	1591958	28	0	1	0	29
2R	1593302	27	0	0	0	27
2R	1593303	26	0	1	0	27
2R	1593310	24	0	4	0	28
2R	1593315	24	0	3	0	27
2R	1593825	14	0	2	0	16
2R	1594032	19	0	1	0	20
2R	1595342	9	0	1	0	10
2R	1595440	15	0	0	0	15
2R	1607075	0	0	0	0	0
2R	1728919	1	0	0	0	1
2R	1738108	0	0	0	0	0
2R	1865062	0	2	0	6	8
2R	1865075	0	5	0	2	7
2R	1865085	0	3	0	4	7
2R	1865087	0	1	0	6	7
2R	1865348	0	0	0	4	4
2R	1865369	0	0	0	3	3
2R	1865574	0	1	0	3	4
2R	1873696	0	2	0	1	3
2R	1891695	0	0	0	1	1
2R	1893555	0	0	0	1	1
2R	1895974	0	0	0	0	0
2R	1905603	0	0	0	0	0
2R	1916341	0	0	0	1	1
2R	1917254	0	0	0	0	0
2R	1958846	0	0	0	1	1
2R	1986061	0	0	0	0	0
2R	1994663	0	0	0	0	0
2R	1994676	0	0	0	0	0
2R	2080600	0	0	0	1	1
2R	2108301	0	0	0	0	0
2R	2191810	0	1	0	1	2
2R	2194077	0	1	0	0	1
2R	2195782	0	0	0	0	0
2R	2202217	0	0	0	1	1
2R	2202225	0	1	0	0	1
2R	2241894	0	0	0	0	0
2R	2246575	0	0	0	0	0
2R	2246585	0	0	0	0	0
2R	2246586	0	0	0	0	0
2R	2246597	0	0	0	0	0
2R	2246605	0	0	0	0	0
2R	2246607	0	0	0	0	0
2R	2246610	0	0	0	0	0
2R	2246614	0	0	0	0	0
2R	2246619	0	0	0	0	0
2R	2246626	0	0	0	0	0
2R	2246628	0	0	0	0	0
2R	2246630	0	0	0	0	0
2R	2246649	0	0	0	0	0
2R	2246650	0	0	0	0	0
2R	2246657	0	0	0	0	0
2R	2246661	0	0	0	0	0
2R	2246666	0	0	0	0	0
2R	2246668	0	0	0	0	0
2R	2246670	0	0	0	0	0
2R	2246672	0	0	0	0	0
2R	2246674	0	0	0	0	0
2R	2246677	0	0	0	0	0
2R	2246691	0	0	0	0	0
2R	2246694	0	0	0	0	0
2R	2246705	0	0	0	0	0
2R	2246718	0	0	0	0	0
2R	2246721	0	0	0	0	0
2R	2246725	0	0	0	0	0
2R	2246749	0	0	0	0	0
2R	2246751	0	0	0	0	0
2R	2246758	0	0	0	0	0
2R	2247749	0	0	0	0	0
2R	2256918	0	0	0	0	0
2R	2257284	0	0	0	0	0
2R	2257289	0	0	0	0	0
2R	2257295	0	0	0	0	0
2R	2257742	0	0	0	0	0
2R	2257793	0	0	0	0	0
2R	2257825	0	0	0	0	0
2R	2257846	0	0	0	1	1
2R	2260195	0	0	0	7	7
2R	2260208	0	0	0	8	8
2R	2260246	0	0	0	10	10
2R	2260647	0	3	0	4	7
2R	2487897	0	0	0	0	0
2R	2487913	0	0	0	0	0
2R	2495761	0	6	0	23	29
2R	2496768	0	15	0	21	36
2R	2496780	0	21	0	9	30
2R	2498338	0	1	0	12	13
2R	2498339	0	1	0	12	13
2R	2498347	0	9	0	4	13
2R	2498348	0	1	0	12	13
2R	2498350	0	4	0	9	13
2R	2498351	0	5	0	8	13
2R	2498353	0	5	0	6	11
2R	2498356	0	7	0	4	11
2R	2498359	0	2	0	10	12
2R	2498363	0	5	0	6	11
2R	2498364	0	5	0	6	11
2R	2517609	0	2	0	3	5
2R	2519999	0	5	0	10	15
2R	2554231	0	0	0	4	4
2R	2554519	0	1	0	0	1
2R	2554530	0	1	0	0	1
2R	2562370	0	0	0	3	3
2R	2562467	0	0	0	8	8
2R	2563510	0	0	0	1	1
2R	2640746	0	0	0	0	0
2R	2820914	0	0	0	2	2
2R	2821043	0	1	0	1	2
2R	2822225	0	0	0	1	1
2R	2822367	0	0	0	1	1
2R	2822866	0	0	0	1	1
2R	2822867	0	0	0	1	1
2R	2822874	0	0	0	1	1
2R	2822875	0	0	0	1	1
2R	2822877	0	0	0	1	1
2R	2822880	0	0	0	1	1
2R	2822883	0	0	0	1	1
2R	2822884	0	0	0	1	1
2R	2822887	0	0	0	1	1
2R	2822888	0	0	0	1	1
2R	2822893	0	1	0	0	1
2R	2822941	0	0	0	1	1
2R	2822942	0	0	0	1	1
2R	2822956	0	0	0	1	1
2R	2822957	0	0	0	1	1
2R	2822958	0	1	0	0	1
2R	2822961	0	0	0	1	1
2R	2822991	0	0	0	1	1
2R	2822995	0	0	0	1	1
2R	2822996	0	0	0	1	1
2R	2822997	0	0	0	1	1
2R	2823003	0	1	0	0	1
2R	2823005	0	1	0	0	1
2R	2823006	0	0	0	1	1
2R	2823007	0	0	0	1	1
2R	2823097	0	1	0	0	1
2R	2823428	0	0	0	1	1
2R	2823645	0	0	0	0	0
2R	2823852	0	0	0	1	1
2R	2831098	0	0	0	1	1
2R	2831110	0	0	0	1	1
2R	2832245	0	0	0	0	0
2R	2843105	0	0	0	2	2
2R	2843112	0	1	0	1	2
2R	2843113	0	0	0	2	2
2R	2843121	0	0	0	2	2
2R	2843122	0	0	0	2	2
2R	2843124	0	0	0	2	2
2R	2843130	0	0	0	1	1
2R	2846308	0	1	0	2	3
2R	2954347	0	0	0	0	0
2R	2954369	0	0	0	0	0
2R	2954754	0	0	0	0	0
2R	2970910	0	0	0	0	0
2R	3104182	0	0	0	0	0
2R	3190285	5	0	2	0	7
2R	3919432	0	3	0	2	5
2R	3932880	0	0	0	0	0
2R	3941840	0	3	0	1	4
2R	4052078	0	0	0	0	0
2R	4052143	0	0	0	0	0
2R	4052192	0	0	0	0	0
2R	4052205	0	0	0	0	0
2R	4052208	0	0	0	0	0
2R	4052224	0	0	0	0	0
2R	4052238	0	0	0	0	0
2R	4052252	0	0	0	0	0
2R	4052268	0	0	0	0	0
2R	4052279	0	0	0	0	0
2R	4220796	0	0	0	0	0
2R	4350268	0	0	0	0	0
2R	4350386	0	0	0	0	0
2R	4367099	0	0	0	0	0
2R	4397570	0	0	0	0	0
2R	4397571	0	0	0	0	0
2R	4397577	0	0	0	0	0
2R	4397580	0	0	0	0	0
2R	4397583	0	0	0	0	0
2R	4397588	0	0	0	0	0
2R	4397601	0	0	0	0	0
2R	4397632	0	0	0	0	0
2R	4397638	0	1	0	0	1
2R	4397643	0	1	0	0	1
2R	4397645	0	0	0	1	1
2R	4397646	0	0	0	1	1
2R	4397658	0	0	0	1	1
2R	4407456	0	0	0	0	0
2R	4407479	0	0	0	0	0
2R	4470411	0	0	0	0	0
2R	4598137	0	0	5	0	5
2R	4610290	2	0	0	0	2
2R	4610327	1	0	0	0	1
2R	4610328	1	0	0	0	1
2R	4610335	1	0	0	0	1
2R	4610338	1	0	0	0	1
2R	4610340	1	0	0	0	1
2R	4610343	1	0	0	0	1
2R	4610344	1	0	0	0	1
2R	4749085	14	0	2	0	16
2R	4787711	0	7	1	76	84
2R	4790435	1	0	0	0	1
2R	4795353	0	0	0	1	1
2R	5027097	0	0	0	0	0
2R	5068277	0	0	0	1	1
2R	5069358	0	0	0	1	1
2R	5069359	0	0	0	1	1
2R	5069360	0	0	0	1	1
2R	5119406	0	7	0	20	27
2R	5120152	0	4	0	5	9
2R	5124254	0	1	0	0	1
2R	5127276	0	0	0	3	3
2R	5211451	0	0	0	0	0
2R	5302757	0	0	0	0	0
2R	5320850	7	0	4	0	11
2R	5337012	0	0	0	0	0
2R	5495400	0	0	1	11	12
2R	5503750	0	0	0	0	0
2R	5503767	0	0	0	0	0
2R	5503911	0	0	0	0	0
2R	5503915	0	0	0	0	0
2R	5504022	0	0	0	0	0
2R	5504026	0	0	0	0	0
2R	5504425	0	0	0	0	0
2R	5504526	0	0	0	0	0
2R	5505677	0	0	0	0	0
2R	5505735	0	0	0	0	0
2R	5505798	0	0	0	0	0
2R	5505800	0	0	0	0	0
2R	5505852	0	0	0	0	0
2R	6031677	0	0	0	0	0
2R	6039689	0	15	0	13	28
2R	6174962	258	0	0	0	258
2R	6571523	0	0	0	0	0
2R	6725344	0	0	0	39	39
2R	6733080	0	1	0	27	28
2R	6733220	0	0	0	32	32
2R	6817728	7	0	2	0	9
2R	6927455	0	1	0	25	26
2R	7130316	0	0	0	14	14
2R	7401894	0	0	0	0	0
2R	7501178	18	0	61	0	79
2R	7502188	7	0	24	0	31
2R	7502199	6	0	24	0	30
2R	7664923	19	0	0	0	19
2R	7813863	79	0	52	0	131
2R	8100701	49	0	19	0	68
2R	8144501	0	1	0	2	3
2R	8464487	179	0	0	0	179
2R	8482655	0	0	1	29	30
2R	8511471	0	0	0	0	0
2R	8616059	143	0	0	0	143
2R	8618670	224	0	0	0	224
2R	8696454	15	0	2	0	17
2R	8876533	63	0	6	0	69
2R	8876790	60	0	11	0	71
2R	8877577	63	0	15	0	78
2R	8883706	4	0	94	0	98
2R	8883745	57	0	43	0	100
2R	8885231	62	0	24	0	86
2R	8885377	62	0	31	0	93
2R	8903673	1331	0	86	0	1417
2R	8903674	1209	0	134	0	1343
2R	8903680	1103	0	333	1	1437
2R	8912445	0	0	0	8	8
2R	9100226	17	0	0	0	17
2R	9110821	10	0	0	0	10
2R	9119427	13	0	0	0	13
2R	9120392	38	0	25	0	63
2R	9158865	0	0	0	35	35
2R	9168104	0	0	0	43	43
2R	9171291	0	0	0	29	29
2R	9171360	0	0	0	30	30
2R	9191664	0	0	0	149	149
2R	9229669	0	21	0	151	172
2R	9229804	0	88	1	402	491
2R	9229936	0	191	0	322	513
2R	9232371	0	0	0	10	10
2R	9234514	0	283	0	203	486
2R	9234519	0	320	0	165	485
2R	9311068	0	8	0	81	89
2R	9312080	0	22	0	37	59
2R	9312087	0	22	0	36	58
2R	9312091	0	5	0	53	58
2R	9312092	31	7	0	16	54
2R	9312093	0	7	0	51	58
2R	9312094	0	3	0	55	58
2R	9328201	0	1	0	3	4
2R	9344191	0	1	0	1	2
2R	9344213	0	0	0	2	2
2R	9345714	0	0	0	5	5
2R	9369253	0	0	0	1	1
2R	9408179	0	1	0	1	2
2R	9440747	0	56	0	11	67
2R	9534930	163	1	75	0	239
2R	9534943	245	0	20	0	265
2R	9539059	0	62	0	115	177
2R	9542736	0	4	0	2	6
2R	9542851	0	4	0	3	7
2R	9592745	0	0	0	0	0
2R	9598728	10	0	0	0	10
2R	9599645	4	0	1	0	5
2R	9619360	0	0	0	0	0
2R	9633098	0	0	0	0	0
2R	9721527	0	0	0	1	1
2R	9723564	0	9	0	36	45
2R	9739197	0	0	0	0	0
2R	9753896	971	0	47	0	1018
2R	9817692	0	0	0	23	23
2R	9819309	0	3	0	20	23
2R	9819328	0	8	0	21	29
2R	9819477	0	0	0	19	19
2R	9819490	0	6	0	12	18
2R	9884160	0	30	0	162	192
2R	9927725	0	0	0	0	0
2R	10011276	0	0	0	0	0
2R	10091619	21	0	0	0	21
2R	10108800	667	0	357	0	1024
2R	10108801	739	0	287	1	1027
2R	10108802	794	0	212	0	1006
2R	10222721	0	0	0	0	0
2R	10278408	8	0	0	0	8
2R	10279089	19	0	0	0	19
2R	10280883	13	0	31	0	44
2R	10280988	22	0	42	0	64
2R	10285619	97	0	0	0	97
2R	10321544	26	0	0	0	26
2R	10327175	0	12	0	3	15
2R	10330783	0	0	0	6	6
2R	10330787	0	5	0	4	9
2R	10330795	0	0	0	9	9
2R	10330796	0	0	0	9	9
2R	10330801	0	0	0	7	7
2R	10330802	0	4	0	2	6
2R	10336774	0	31	0	22	53
2R	10378403	0	0	0	0	0
2R	10378432	0	0	0	0	0
2R	10378433	0	0	0	0	0
2R	10392192	0	0	0	5	5
2R	10393990	0	0	0	3	3
2R	10472135	0	150	0	90	240
2R	10531606	0	1	0	8	9
2R	10540485	0	0	0	2	2
2R	10611461	146	0	12	0	158
2R	10611464	136	0	19	0	155
2R	10706747	17	0	2	0	19
2R	10783584	0	0	0	0	0
2R	10785766	0	3	0	0	3
2R	10785846	0	6	0	2	8
2R	10788717	5	0	0	0	5
2R	10789955	0	0	1	0	1
2R	10815342	57	0	0	0	57
2R	10837913	0	446	0	0	446
2R	10840470	1	114	0	17	132
2R	10855471	0	0	0	0	0
2R	11148789	0	21	0	27	48
2R	11229833	0	0	0	119	119
2R	11293045	0	12	0	58	70
2R	11447601	59	0	302	0	361
2R	11447607	9	0	370	0	379
2R	11447617	67	0	295	0	362
2R	11447623	89	0	277	0	366
2R	11447933	400	0	0	0	400
2R	11447935	357	0	37	0	394
2R	11447987	274	0	155	0	429
2R	11450317	165	0	222	0	387
2R	11450318	181	0	207	0	388
2R	11603464	0	0	0	1	1
2R	11635584	0	0	0	0	0
2R	11635585	0	0	0	0	0
2R	11635587	0	0	0	0	0
2R	11635588	0	0	0	0	0
2R	11671280	0	0	0	0	0
2R	11779856	0	0	0	0	0
2R	11827392	0	0	0	7	7
2R	11845525	32	0	7	0	39
2R	11893047	6	0	0	0	6
2R	11990709	28	0	4	0	32
2R	12024356	0	2	0	3	5
2R	12025551	0	2	0	3	5
2R	12025588	0	4	0	0	4
2R	12265428	11	0	1	0	12
2R	12269039	5	0	1	0	6
2R	12328060	51	0	0	0	51
2R	12328068	51	0	0	0	51
2R	12328073	52	0	0	0	52
2R	12329738	0	0	0	0	0
2R	12350262	2	0	0	0	2
2R	12448654	98	0	40	0	138
2R	12448686	87	0	75	0	162
2R	12448723	117	0	62	0	179
2R	12448779	81	0	87	0	168
2R	12469039	11	0	0	0	11
2R	12470834	12	0	0	0	12
2R	12489327	0	0	0	121	121
2R	12648195	0	0	0	6	6
2R	12754897	0	1	0	0	1
2R	12758582	46	0	69	0	115
2R	12800608	4	0	22	0	26
2R	12800859	30	0	7	0	37
2R	12921246	179	0	140	0	319
2R	12921325	215	0	159	0	374
2R	12921326	297	0	75	0	372
2R	13437401	0	0	0	13	13
2R	13517261	0	15	0	178	193
2R	13517274	0	60	0	111	171
2R	13517275	0	112	0	53	165
2R	13517347	0	35	0	124	159
2R	13580366	1	0	0	0	1
2R	13747628	4	0	28	0	32
2R	13748897	0	0	51	2	53
2R	13809071	37	0	15	0	52
2R	13809547	23	0	124	0	147
2R	13809607	71	0	58	0	129
2R	13809962	103	0	84	1	188
2R	13810199	79	0	58	0	137
2R	13817109	135	1	46	0	182
2R	13817124	139	1	6	0	146
2R	13817379	37	0	195	0	232
2R	13823895	0	1	0	76	77
2R	13846257	2	0	0	0	2
2R	13858942	0	0	0	0	0
2R	13885952	0	0	0	98	98
2R	13886458	0	21	0	57	78
2R	13887556	0	61	0	33	94
2R	13893580	0	15	0	48	63
2R	13893934	0	33	0	22	55
2R	13916837	0	0	0	0	0
2R	13974052	0	0	0	75	75
2R	14062507	0	12	0	79	91
2R	14062651	0	46	0	44	90
2R	14062768	0	40	0	69	109
2R	14062771	0	67	0	42	109
2R	14062774	0	15	0	95	110
2R	14149035	0	0	0	71	71
2R	14152423	0	5	0	0	5
2R	14153104	0	0	0	0	0
2R	14171351	17	0	0	0	17
2R	14172781	238	0	56	0	294
2R	14178731	137	0	47	0	184
2R	14182106	74	0	16	0	90
2R	14215739	0	2	0	0	2
2R	14297994	272	0	54	0	326
2R	14331618	0	0	0	0	0
2R	14334547	1	0	0	0	1
2R	14355520	34	0	5	0	39
2R	14361978	0	2	0	0	2
2R	14507629	44	0	0	0	44
2R	14538499	0	0	0	0	0
2R	14555183	0	0	0	0	0
2R	14740426	0	4	0	256	260
2R	14741592	0	151	0	103	254
2R	14742174	0	20	0	332	352
2R	14742210	0	111	0	224	335
2R	14742223	1	71	1	251	324
2R	14742241	0	287	0	48	335
2R	14742359	0	0	0	320	320
2R	14756598	328	0	0	0	328
2R	14762018	0	89	0	115	204
2R	14971913	0	0	100	0	100
2R	15264046	0	38	0	47	85
2R	15264051	0	30	0	48	78
2R	15264096	0	54	0	21	75
2R	15264743	0	27	0	68	95
2R	15415679	15	0	0	0	15
2R	15456269	10	0	3	0	13
2R	15460575	10	0	1	0	11
2R	15460578	10	0	0	0	10
2R	15516140	0	3	0	63	66
2R	15518712	0	45	0	68	113
2R	15765728	0	0	0	18	18
2R	15766457	0	0	0	17	17
2R	15772754	0	0	0	3	3
2R	15772755	0	1	0	2	3
2R	15775053	0	5	0	20	25
2R	15777061	0	8	0	3	11
2R	15779915	0	0	0	1	1
2R	15779918	0	0	0	1	1
2R	15779987	0	1	0	0	1
2R	15779998	0	0	0	1	1
2R	15786556	0	0	0	0	0
2R	15809225	0	0	0	0	0
2R	15871835	0	50	0	25	75
2R	15872366	0	89	0	25	114
2R	15980167	0	1	0	5	6
2R	16336488	8	0	1	0	9
2R	16432544	13	0	0	0	13
2R	16534056	0	0	0	0	0
2R	16576409	0	76	0	0	76
2R	16647491	67	0	10	0	77
2R	16647492	17	0	59	0	76
2R	16647565	72	0	9	0	81
2R	16647597	80	0	7	0	87
2R	16647631	19	0	65	0	84
2R	16650664	67	0	6	0	73
2R	16650669	71	0	0	0	71
2R	16650728	85	0	0	0	85
2R	16650742	81	0	3	0	84
2R	16650776	52	0	27	0	79
2R	16650779	76	0	3	0	79
2R	16650790	42	0	35	0	77
2R	16650805	57	0	10	0	67
2R	16650890	47	0	4	0	51
2R	16762451	0	0	0	1	1
2R	16765101	0	0	0	15	15
2R	16917584	0	0	0	0	0
2R	16932924	22	0	0	0	22
2R	17222715	0	0	0	0	0
2R	17364649	8	0	0	0	8
2R	17374869	16	0	24	0	40
2R	17375028	32	0	17	0	49
2R	17375029	41	0	8	0	49
2R	17375057	23	0	27	0	50
2R	17375058	27	0	25	0	52
2R	17377109	19	0	62	0	81
2R	17377110	23	0	62	0	85
2R	17377122	25	0	53	0	78
2R	17377125	45	0	32	0	77
2R	17377403	37	0	16	0	53
2R	17701194	0	0	0	1	1
2R	18020907	0	0	0	0	0
2R	18134284	0	0	0	7	7
2R	18145289	3	0	0	0	3
2R	18167781	126	0	0	0	126
2R	18173890	29	0	11	0	40
2R	18281192	0	1	0	90	91
2R	18356868	0	2	0	14	16
2R	18518047	1	0	0	0	1
2R	18518048	1	0	1	0	2
2R	18720854	1	0	0	0	1
2R	18743376	0	0	0	1	1
2R	18865057	0	0	0	0	0
2R	18998450	5	0	0	0	5
2R	19006082	60	0	27	0	87
2R	19006586	0	0	0	0	0
2R	19138221	0	0	0	3	3
2R	19139754	104	0	0	0	104
2R	19179174	12	0	0	0	12
2R	19223379	48	0	12	0	60
2R	19223636	54	0	46	0	100
2R	19225658	117	0	38	0	155
2R	19303685	56	0	20	0	76
2R	19326309	0	18	0	21	39
2R	19525936	0	0	0	16	16
2R	19566903	0	4	0	14	18
2R	19625834	0	0	0	0	0
2R	19727230	0	0	0	0	0
2R	20424540	79	0	0	0	79
2R	20658504	0	0	9	0	9
2R	21145178	469	0	43	0	512
2R	21315686	146	0	37	0	183
2R	21334960	6	0	11	0	17
2R	21480214	0	11	0	50	61
2R	21557174	24	0	41	0	65
2R	21620849	0	33	0	42	75
2R	21621075	0	34	0	36	70
2R	21653466	32	0	52	0	84
2R	21851363	0	0	0	0	0
2R	22175545	27	0	0	0	27
2R	22227209	0	0	0	37	37
2R	22391510	25	0	94	0	119
2R	22564373	0	33	0	81	114
2R	22564377	0	33	0	82	115
2R	22568445	0	0	0	0	0
2R	22573070	0	1	0	0	1
2R	22587796	0	0	0	1	1
2R	22637905	60	0	0	0	60
2R	22673075	15	0	0	0	15
2R	22746263	0	6	0	8	14
2R	23381950	0	0	0	30	30
2R	23598132	24	0	2	0	26
2R	23804970	0	0	0	0	0
2R	23838782	29	0	2	0	31
2R	23844274	0	0	0	54	54
2R	23867196	0	0	0	331	331
2R	24006102	0	4	0	59	63
2R	24006115	0	0	0	55	55
2R	24006555	0	80	0	12	92
2R	24046125	0	1	0	0	1
2R	24050977	38	0	19	0	57
2R	24051555	58	0	8	0	66
2R	24218949	0	0	0	0	0
2R	24332337	0	0	0	1	1
2R	24384812	0	48	0	11	59
2R	24419247	0	130	0	10	140
2R	24419250	0	129	0	12	141
2R	24500965	0	0	0	0	0
2R	24512318	0	15	0	106	121
2R	24882682	130	0	16	0	146
2R	24882751	115	0	37	0	152
2R	24885850	86	0	16	0	102
2R	24904717	133	0	21	0	154
2R	24910398	159	0	88	0	247
2R	24910568	137	0	56	0	193
2R	24910752	145	0	23	0	168
2R	24910775	31	0	136	0	167
2R	24910814	106	1	95	0	202
2R	24910823	91	0	121	0	212
2R	24911061	82	0	114	0	196
2R	24911109	88	0	115	0	203
2R	24912004	110	0	28	1	139
2R	24912848	39	0	179	0	218
2R	24912923	229	0	0	0	229
2R	24914689	137	0	28	0	165
2R	24914702	59	0	102	0	161
2R	24914794	41	0	90	0	131
2R	24914829	126	0	18	0	144
2R	24914858	20	0	153	0	173
2R	24914859	164	0	11	0	175
2R	24914864	59	0	127	0	186
2R	24914865	66	0	120	0	186
2R	24914874	90	0	104	0	194
2R	24919093	196	0	25	0	221
2R	24920153	89	0	1	0	90
2R	24995597	0	28	0	77	105
2R	24995857	0	42	0	69	111
2R	25255069	39	0	4	0	43
2R	25255079	22	0	25	0	47
2R	25255082	20	0	28	0	48
2R	25255913	60	0	7	0	67
2R	25256658	20	0	16	0	36
2R	25257110	26	0	2	0	28
2R	25257267	25	0	36	0	61
2R	25257297	48	0	23	0	71
2R	25257312	22	0	39	0	61
2R	25257313	9	0	53	0	62
2R	25257314	24	0	37	0	61
2R	25257317	39	0	25	0	64
2R	25257328	39	0	23	0	62
2R	25257336	49	0	7	0	56
2R	25257337	50	1	9	0	60
2R	25257342	12	0	51	0	63
2R	25257343	15	0	47	0	62
2R	25257375	66	0	1	0	67
2R	25257376	52	0	14	0	66
2R	25257377	38	0	31	0	69
2R	25257383	40	0	31	0	71
2R	25257388	46	0	21	0	67
2R	25257391	50	0	28	0	78
2R	25257392	61	0	15	0	76
2R	25257393	70	0	8	0	78
2R	25257394	50	0	30	0	80
2R	25257396	81	0	0	0	81
2R	25257397	64	0	14	0	78
2R	25257398	61	0	20	0	81
2R	25257404	40	0	34	0	74
2R	25257405	20	0	51	0	71
2R	25257406	27	0	45	0	72
2R	25257414	58	0	18	0	76
2R	25257417	38	0	40	0	78
2R	25257418	35	0	38	0	73
2R	25257420	61	0	16	0	77
2R	25257424	73	0	11	0	84
2R	25257425	17	0	66	0	83
2R	25257426	15	0	66	0	81
2R	25257427	64	0	18	0	82
2R	25257431	84	0	5	0	89
2R	25257439	67	0	15	0	82
2R	25257445	52	0	20	0	72
2R	25257451	28	0	55	0	83
2R	25257453	81	0	3	0	84
2R	25257483	64	0	25	0	89
2R	25257508	54	0	51	0	105
2R	25257625	49	0	8	0	57
2R	25257632	48	0	5	0	53
2R	25257633	52	0	2	0	54
2R	25257638	53	0	1	0	54
2R	25257643	33	0	18	0	51
2R	25257682	15	0	19	0	34
2R	25257683	21	0	12	0	33
2R	25257699	23	0	1	0	24
2R	25257701	22	0	3	0	25
2R	25257703	12	0	13	0	25
2R	25257714	17	0	12	0	29
2R	25257732	11	0	16	0	27
2R	25257735	13	0	13	0	26
2R	25257740	16	0	11	0	27
2R	25257741	15	0	10	0	25
2R	25257743	23	0	4	0	27
2R	25257781	17	0	8	0	25
2R	25257788	25	0	0	0	25
2R	25257789	22	0	1	0	23
2R	25257792	17	0	4	0	21
2R	25257806	13	0	11	0	24
2R	25257812	16	0	4	0	20
2R	25257820	17	0	4	0	21
2R	25257832	10	0	9	0	19
2R	25257836	3	0	17	0	20
2R	25257964	3	0	11	0	14
3L	71000	0	0	0	0	0
3L	214328	0	24	0	0	24
3L	226141	2167	0	88	0	2255
3L	271201	0	0	1	0	1
3L	336697	0	0	0	0	0
3L	346424	2	0	0	0	2
3L	346882	0	0	0	13	13
3L	411895	0	0	0	0	0
3L	462074	0	0	0	0	0
3L	498116	0	0	0	0	0
3L	546751	0	0	0	0	0
3L	575217	53	0	0	0	53
3L	598790	15	0	6	0	21
3L	991441	81	0	10	0	91
3L	1010857	0	0	1	0	1
3L	1011246	0	0	0	0	0
3L	1011285	0	0	0	0	0
3L	1026639	0	12	0	80	92
3L	1027109	0	38	0	71	109
3L	1033059	0	0	0	0	0
3L	1034384	0	0	0	3	3
3L	1034386	0	0	0	3	3
3L	1044064	2	0	0	0	2
3L	1046651	0	0	0	0	0
3L	1135014	0	0	0	0	0
3L	1138357	0	0	0	0	0
3L	1210848	0	0	0	0	0
3L	1217228	1	0	0	0	1
3L	1227904	0	0	0	0	0
3L	1230644	0	0	59	0	59
3L	1318745	0	1	0	0	1
3L	1407143	0	0	0	0	0
3L	1490348	0	0	0	8	8
3L	1526045	0	0	0	16	16
3L	1556299	0	0	0	193	193
3L	1689558	9	0	0	0	9
3L	1727806	0	0	0	0	0
3L	1782670	1	255	0	207	463
3L	1945203	0	0	0	4	4
3L	2001719	0	0	0	0	0
3L	2039782	0	4	0	40	44
3L	2039908	0	13	0	77	90
3L	2039918	0	33	0	62	95
3L	2039919	0	3	0	90	93
3L	2042849	0	0	0	105	105
3L	2043519	0	0	0	116	116
3L	2044551	1	0	0	89	90
3L	2044916	0	0	0	103	103
3L	2045959	0	0	0	95	95
3L	2051548	0	0	0	41	41
3L	2054348	0	0	0	7	7
3L	2055902	0	0	0	0	0
3L	2056964	0	0	0	4	4
3L	2060460	0	0	0	3	3
3L	2074107	0	0	0	23	23
3L	2080672	0	0	0	34	34
3L	2080891	0	0	0	27	27
3L	2089039	0	0	0	12	12
3L	2096769	0	0	0	63	63
3L	2125496	0	1	0	169	170
3L	2126093	0	20	0	182	202
3L	2134649	0	0	0	92	92
3L	2135049	0	0	0	114	114
3L	2190111	0	0	0	86	86
3L	2245947	0	0	0	0	0
3L	2251644	0	0	0	0	0
3L	2348350	0	0	0	0	0
3L	2372937	0	0	35	0	35
3L	2377732	0	0	0	3	3
3L	2390472	0	0	0	0	0
3L	2424958	0	0	0	0	0
3L	2440451	4	0	0	0	4
3L	2458238	22	0	0	0	22
3L	2469405	1	0	0	0	1
3L	2469912	0	0	0	0	0
3L	2473344	0	0	0	0	0
3L	2481805	0	0	0	0	0
3L	2498728	0	0	0	83	83
3L	2499964	0	0	1	1347	1348
3L	2519293	0	0	0	2	2
3L	2578670	0	0	0	0	0
3L	2657532	0	95	0	0	95
3L	2665990	0	19	0	45	64
3L	2666151	0	39	0	10	49
3L	2773256	0	0	0	70	70
3L	2773526	0	0	0	56	56
3L	2777176	0	0	43	0	43
3L	2778433	66	0	0	0	66
3L	2778439	0	0	66	0	66
3L	2784069	0	24	0	0	24
3L	2784359	0	0	24	1	25
3L	2785524	0	0	16	0	16
3L	2785531	0	0	0	16	16
3L	2785536	0	0	0	15	15
3L	2785542	0	18	0	0	18
3L	2785610	0	15	0	0	15
3L	2785621	0	0	0	16	16
3L	2785658	18	0	0	0	18
3L	2786034	0	0	0	0	0
3L	2791593	0	0	0	44	44
3L	2799685	0	0	0	0	0
3L	2882059	0	0	0	0	0
3L	2924789	165	0	10	0	175
3L	2924790	162	0	15	0	177
3L	2924829	106	0	67	0	173
3L	2925090	35	0	99	0	134
3L	2925255	13	0	115	0	128
3L	2925550	0	0	65	0	65
3L	2939953	86	0	42	0	128
3L	2940825	182	0	1	0	183
3L	2940919	130	0	31	0	161
3L	2941131	33	0	153	0	186
3L	2941132	14	0	170	1	185
3L	2941311	144	0	19	0	163
3L	2941312	7	0	157	0	164
3L	2941364	11	0	157	0	168
3L	2941396	42	0	108	0	150
3L	2941425	55	0	106	0	161
3L	2941426	2	0	155	0	157
3L	2961305	0	0	0	0	0
3L	3086223	141	0	28	0	169
3L	3114961	0	0	0	79	79
3L	3150180	0	0	0	0	0
3L	3226015	10	0	2	0	12
3L	3311439	0	1	0	0	1
3L	3359345	47	0	54	0	101
3L	3361215	0	115	0	0	115
3L	3371858	0	87	1	52	140
3L	3371901	0	78	0	65	143
3L	3371976	0	46	0	133	179
3L	3407053	0	0	0	3	3
3L	3442381	0	0	0	0	0
3L	3471786	0	0	0	75	75
3L	3555912	0	0	0	0	0
3L	3729820	0	0	0	0	0
3L	3761976	0	0	0	2	2
3L	3762337	0	0	0	0	0
3L	3781259	0	28	0	0	28
3L	3786975	0	0	0	0	0
3L	3815844	2	0	0	0	2
3L	3837134	93	0	1	0	94
3L	3892642	0	0	87	0	87
3L	3904309	0	0	0	0	0
3L	3988087	47	0	3	0	50
3L	4089220	0	0	0	1	1
3L	4092326	753	0	10	0	763
3L	4172458	0	0	39	0	39
3L	4198341	24	0	26	0	50
3L	4264563	0	0	0	0	0
3L	4307932	0	0	0	0	0
3L	4308806	0	0	0	0	0
3L	4314575	0	0	0	0	0
3L	4314576	0	0	0	0	0
3L	4314586	0	0	0	0	0
3L	4316475	0	0	0	0	0
3L	4317484	0	1	0	0	1
3L	4317522	0	0	0	0	0
3L	4317524	0	0	0	0	0
3L	4317564	0	0	1	0	1
3L	4318105	0	0	0	0	0
3L	4318481	0	0	0	0	0
3L	4369162	0	177	0	90	267
3L	4369184	0	198	0	78	276
3L	4369185	1	110	0	168	279
3L	4369207	0	21	0	308	329
3L	4369208	0	16	0	303	319
3L	4369213	0	30	0	299	329
3L	4369313	0	0	0	326	326
3L	4369422	0	61	0	147	208
3L	4369445	0	15	0	163	178
3L	4369455	0	12	0	194	206
3L	4369459	0	12	0	183	195
3L	4429963	21	0	189	2	212
3L	4429967	121	0	90	0	211
3L	4430199	77	0	21	2	100
3L	4430208	22	0	85	0	107
3L	4431761	23	0	164	0	187
3L	4432486	86	0	128	0	214
3L	4432487	37	0	172	0	209
3L	4433319	186	0	105	0	291
3L	4433320	26	0	256	0	282
3L	4446288	0	0	0	0	0
3L	4584256	19	0	68	0	87
3L	4585849	68	0	30	0	98
3L	4585851	83	0	15	0	98
3L	4585858	73	0	21	0	94
3L	4585859	22	0	65	0	87
3L	4585865	57	0	27	0	84
3L	4586039	56	0	2	0	58
3L	4586053	49	0	14	0	63
3L	4586714	330	0	58	0	388
3L	4586715	75	0	305	0	380
3L	4590437	183	0	35	1	219
3L	4590448	182	0	49	0	231
3L	4590461	237	0	15	0	252
3L	4590463	248	0	6	0	254
3L	4590484	248	0	21	0	269
3L	4590685	127	0	117	0	244
3L	4590708	194	0	74	1	269
3L	4590709	122	0	147	0	269
3L	4591116	100	0	105	0	205
3L	4591123	192	0	15	0	207
3L	4591132	173	0	34	0	207
3L	4591179	211	0	38	0	249
3L	4591222	243	0	46	0	289
3L	4591226	284	0	18	0	302
3L	4591259	247	0	31	0	278
3L	4591369	248	0	43	0	291
3L	4591744	235	0	13	0	248
3L	4732441	0	0	0	0	0
3L	4811851	0	0	3	0	3
3L	4822418	60	0	0	0	60
3L	4822420	59	0	0	0	59
3L	4867777	0	0	0	0	0
3L	4897294	0	0	0	0	0
3L	4985909	0	1	0	0	1
3L	4986257	0	0	0	0	0
3L	4986611	0	0	0	0	0
3L	4986891	0	0	0	0	0
3L	5045427	0	0	0	0	0
3L	5102529	0	0	0	0	0
3L	5116849	0	2	0	0	2
3L	5133159	0	0	9	0	9
3L	5133686	0	0	0	0	0
3L	5135062	69	0	0	0	69
3L	5135116	82	0	0	0	82
3L	5139737	51	0	0	0	51
3L	5144164	0	0	3	0	3
3L	5157874	0	3	0	101	104
3L	5160640	0	0	0	78	78
3L	5171594	0	0	0	0	0
3L	5171618	1	0	0	0	1
3L	5185014	0	0	0	2	2
3L	5188016	0	0	0	1	1
3L	5191766	0	0	0	2	2
3L	5192055	0	0	0	0	0
3L	5212866	2	0	0	0	2
3L	5212915	0	1	0	0	1
3L	5212920	0	2	0	0	2
3L	5213133	0	0	0	1	1
3L	5213134	1	0	0	0	1
3L	5247676	0	0	0	10	10
3L	5334897	0	0	0	0	0
3L	5347418	0	0	0	0	0
3L	5435357	0	0	0	0	0
3L	5664597	0	0	0	0	0
3L	5692734	3	0	0	0	3
3L	5696130	8	0	9	0	17
3L	5740525	13	0	29	0	42
3L	5743791	22	0	5	0	27
3L	5745060	26	0	3	0	29
3L	5746701	167	0	0	0	167
3L	5746708	165	0	10	0	175
3L	5746772	140	0	31	0	171
3L	5750034	0	0	0	4	4
3L	5764525	0	0	0	119	119
3L	5815976	0	0	4	0	4
3L	6008890	0	0	0	0	0
3L	6008957	0	0	0	0	0
3L	6009017	0	0	0	0	0
3L	6062381	0	0	0	1	1
3L	6193542	31	0	0	0	31
3L	6285897	0	0	0	0	0
3L	6331348	22	0	0	0	22
3L	6459287	0	0	0	0	0
3L	6506202	0	1	0	0	1
3L	6506212	1	0	0	0	1
3L	6534871	0	0	0	0	0
3L	6641116	0	0	0	0	0
3L	6643565	0	0	0	0	0
3L	6643648	0	0	0	0	0
3L	6643649	0	0	0	0	0
3L	6643749	0	0	0	0	0
3L	6643752	0	0	0	0	0
3L	6689091	0	0	0	0	0
3L	6689204	0	0	0	0	0
3L	6694843	0	0	0	2	2
3L	6734513	67	0	0	0	67
3L	6754914	0	33	0	0	33
3L	6769182	0	0	0	0	0
3L	6786307	0	0	6	0	6
3L	6800394	0	0	1	0	1
3L	6800402	0	0	0	1	1
3L	6949680	0	113	0	441	554
3L	6949683	0	20	0	535	555
3L	6949688	0	136	0	427	563
3L	6949690	0	122	0	447	569
3L	6950110	1	231	0	496	728
3L	6950168	1	144	0	784	929
3L	6954754	0	567	0	696	1263
3L	7021467	0	0	0	0	0
3L	7059577	0	0	0	40	40
3L	7180438	0	37	0	45	82
3L	7218079	0	0	0	0	0
3L	7235679	0	0	0	0	0
3L	7236912	0	0	0	0	0
3L	7324105	0	0	0	19	19
3L	7326096	11	0	1	0	12
3L	7417841	0	0	0	0	0
3L	7650269	0	0	0	0	0
3L	7654672	0	9	0	51	60
3L	7665256	536	0	0	0	536
3L	7666636	0	22	0	33	55
3L	7694236	0	0	0	2	2
3L	7696248	0	0	0	4	4
3L	7830703	0	7	0	29	36
3L	7923214	0	0	0	0	0
3L	7928680	0	71	0	25	96
3L	7939905	0	0	0	0	0
3L	7960324	0	0	0	0	0
3L	7979842	0	0	0	0	0
3L	8041599	2	0	0	0	2
3L	8066395	0	0	0	0	0
3L	8120375	0	0	83	0	83
3L	8120519	0	0	105	0	105
3L	8121502	8	0	0	0	8
3L	8126738	0	0	38	0	38
3L	8126864	25	0	0	0	25
3L	8184846	0	0	35	0	35
3L	8185142	0	0	0	0	0
3L	8228580	0	0	0	0	0
3L	8375374	0	0	0	0	0
3L	8434395	0	0	0	72	72
3L	8444869	0	3	0	0	3
3L	8492631	1	0	0	0	1
3L	8532834	0	0	0	60	60
3L	8532845	0	60	0	0	60
3L	8588267	0	0	201	0	201
3L	8588835	5	0	0	0	5
3L	8589446	16	0	4	0	20
3L	8597507	306	0	1	0	307
3L	8648332	10975	2	1	0	10978
3L	8678627	0	0	80	0	80
3L	8678628	0	0	79	0	79
3L	8678673	99	0	0	0	99
3L	8719077	19	0	0	0	19
3L	8724069	5	0	0	0	5
3L	8736015	0	0	0	2	2
3L	8740095	0	15	0	312	327
3L	8759599	7	0	0	0	7
3L	8775212	0	0	0	0	0
3L	8786152	56	0	0	0	56
3L	8798415	35	0	0	0	35
3L	8827752	0	0	63	0	63
3L	8839904	0	0	0	0	0
3L	8844956	0	0	0	0	0
3L	8850667	1	0	0	0	1
3L	8885355	0	0	0	0	0
3L	8892723	2	0	0	0	2
3L	8913159	1	0	0	0	1
3L	8913856	0	0	0	0	0
3L	8913897	0	0	0	0	0
3L	8931961	31	0	0	0	31
3L	8940166	60	0	0	0	60
3L	8983591	0	390	0	0	390
3L	8985580	0	32	0	1	33
3L	8987752	0	0	0	93	93
3L	8991591	0	21	0	0	21
3L	8993217	0	42	0	0	42
3L	8997822	0	22	0	0	22
3L	9100899	0	0	0	15	15
3L	9124178	0	0	0	4	4
3L	9124180	0	0	0	4	4
3L	9124570	0	2	0	4	6
3L	9144950	255	0	1	0	256
3L	9146324	38	0	0	0	38
3L	9147825	0	0	0	16	16
3L	9149081	0	0	0	28	28
3L	9151835	0	7	0	37	44
3L	9151836	0	6	0	42	48
3L	9155185	0	24	0	44	68
3L	9155218	0	59	0	5	64
3L	9161860	0	1	0	5	6
3L	9161861	0	1	0	6	7
3L	9161863	0	2	0	5	7
3L	9161864	0	0	0	8	8
3L	9161865	0	0	0	8	8
3L	9162917	0	34	0	39	73
3L	9162924	0	18	0	48	66
3L	9172898	0	0	4	0	4
3L	9258715	4	0	0	0	4
3L	9263686	0	1	0	0	1
3L	9270392	0	0	29	0	29
3L	9282077	4	0	0	0	4
3L	9287571	0	0	0	25	25
3L	9341681	1	0	0	0	1
3L	9378596	0	0	0	51	51
3L	9488590	0	3	0	0	3
3L	9497783	0	0	0	8	8
3L	9562249	0	0	0	0	0
3L	9566820	0	0	0	0	0
3L	9566821	0	0	0	0	0
3L	9587305	14	0	0	0	14
3L	9608849	0	0	0	0	0
3L	9622044	29	0	0	0	29
3L	9625888	0	0	7	0	7
3L	9631909	0	0	0	38	38
3L	9632368	0	0	0	138	138
3L	9633307	0	0	0	172	172
3L	9644938	15	0	0	0	15
3L	9645414	0	0	0	26	26
3L	9648209	0	0	0	0	0
3L	9649368	0	0	0	0	0
3L	9666680	0	0	0	0	0
3L	9668976	0	41	0	29	70
3L	9682712	0	0	0	0	0
3L	9682988	0	0	1	0	1
3L	9686533	0	0	0	48	48
3L	9688751	0	0	0	34	34
3L	9709045	1	0	139	0	140
3L	9717933	0	0	0	3	3
3L	9724380	0	0	0	2	2
3L	9724514	0	4	0	0	4
3L	9724607	0	0	0	0	0
3L	9730982	1437	0	0	0	1437
3L	9734333	0	0	0	185	185
3L	9736382	0	0	0	21	21
3L	9736627	0	0	0	22	22
3L	9738180	0	305	1	0	306
3L	9740249	0	13	0	0	13
3L	9740401	0	20	0	0	20
3L	9774568	0	0	1	0	1
3L	9799424	2	0	0	0	2
3L	9807026	0	0	1	0	1
3L	9814841	0	1	0	0	1
3L	9815342	0	0	1	0	1
3L	9816197	0	0	1	0	1
3L	9816249	0	0	0	0	0
3L	9816250	0	0	1	0	1
3L	9816252	0	0	1	0	1
3L	9816265	18	0	0	0	18
3L	9816267	0	0	24	0	24
3L	9817489	0	0	0	0	0
3L	9819018	0	0	0	0	0
3L	9821256	0	0	0	0	0
3L	9821464	0	0	0	0	0
3L	9821472	0	0	0	0	0
3L	9821474	0	0	0	0	0
3L	9821481	0	0	0	0	0
3L	9821685	0	0	0	9	9
3L	9833291	258	0	28	0	286
3L	9833294	208	0	110	0	318
3L	9833300	166	0	155	0	321
3L	9833301	111	0	201	1	313
3L	9833364	258	0	12	0	270
3L	9833369	70	0	215	0	285
3L	9833370	273	0	21	0	294
3L	9833459	179	0	97	0	276
3L	9833484	248	0	51	0	299
3L	9833487	278	0	25	0	303
3L	9867222	93	0	22	0	115
3L	9867339	94	0	131	0	225
3L	9885244	0	0	0	14	14
3L	9885764	0	0	0	11	11
3L	9886836	0	0	0	8	8
3L	9892134	24	0	27	0	51
3L	9943795	0	0	0	0	0
3L	9943907	0	0	0	0	0
3L	9972754	6	0	0	0	6
3L	9974737	11	0	0	0	11
3L	10023375	0	0	0	0	0
3L	10153722	0	0	0	4	4
3L	10182898	0	0	0	4	4
3L	10182954	0	1	0	2	3
3L	10185757	0	3	0	1	4
3L	10197944	0	0	0	0	0
3L	10287759	0	0	1	0	1
3L	10358012	0	0	0	2	2
3L	10423429	0	0	0	0	0
3L	10478991	0	0	0	0	0
3L	10516387	1	0	1	0	2
3L	10556226	1	0	0	0	1
3L	10583448	0	11	0	0	11
3L	10644076	0	0	110	1	111
3L	10659046	0	0	0	0	0
3L	10672257	0	0	0	0	0
3L	10785536	0	0	0	0	0
3L	10787010	0	0	0	0	0
3L	10787012	0	0	0	0	0
3L	10820249	0	0	0	0	0
3L	10848012	0	0	0	0	0
3L	10944093	0	0	0	0	0
3L	11038040	0	1	0	122	123
3L	11067981	15	0	0	0	15
3L	11073860	0	0	0	109	109
3L	11166174	0	15	0	0	15
3L	11166793	12	0	0	0	12
3L	11166799	0	0	0	12	12
3L	11166802	0	0	0	12	12
3L	11166932	0	0	0	16	16
3L	11175776	2	0	1	0	3
3L	11175795	4	0	1	0	5
3L	11175891	3	0	1	0	4
3L	11175895	2	0	2	0	4
3L	11175896	4	0	0	0	4
3L	11176183	2	0	2	0	4
3L	11176185	2	0	2	0	4
3L	11178469	0	0	160	0	160
3L	11203066	0	0	0	39	39
3L	11209891	0	0	28	0	28
3L	11211185	47	0	0	0	47
3L	11211200	40	0	0	0	40
3L	11218031	0	0	0	1	1
3L	11218035	0	0	1	0	1
3L	11218227	0	1	0	0	1
3L	11225111	101	1	0	0	102
3L	11225150	60	0	39	0	99
3L	11280036	0	0	0	0	0
3L	11519814	0	11	0	0	11
3L	11552592	0	0	0	4	4
3L	11553320	0	0	0	0	0
3L	11553330	0	0	0	0	0
3L	11553333	0	0	0	0	0
3L	11559570	0	0	0	0	0
3L	11599583	0	0	0	0	0
3L	11650023	0	0	0	59	59
3L	11670833	0	0	0	0	0
3L	11734662	0	3	0	62	65
3L	11746631	0	0	0	0	0
3L	11764981	0	1	0	0	1
3L	11803246	0	1	0	0	1
3L	11807770	0	0	0	0	0
3L	11815790	0	25	0	0	25
3L	11824846	14	0	0	0	14
3L	11827577	0	0	0	0	0
3L	11837250	0	0	0	0	0
3L	11837265	0	0	0	0	0
3L	11857720	0	0	0	0	0
3L	11857797	0	0	0	0	0
3L	11857887	0	0	1	0	1
3L	11857906	0	0	1	0	1
3L	11956759	0	0	0	0	0
3L	11964188	0	0	0	0	0
3L	11974542	0	0	0	0	0
3L	12022418	0	0	1	0	1
3L	12023402	0	0	0	0	0
3L	12066158	0	0	0	0	0
3L	12070965	0	19	0	0	19
3L	12100697	0	0	0	0	0
3L	12105494	0	0	0	0	0
3L	12123225	0	0	0	435	435
3L	12211671	0	70	0	45	115
3L	12211756	0	20	0	83	103
3L	12212148	0	73	0	7	80
3L	12212309	0	85	0	9	94
3L	12239964	0	0	0	0	0
3L	12244780	0	0	0	0	0
3L	12252166	0	0	0	0	0
3L	12297495	0	0	0	0	0
3L	12423647	0	0	0	0	0
3L	12426521	0	0	0	0	0
3L	12430208	0	0	0	0	0
3L	12440786	0	0	0	0	0
3L	12445033	0	0	0	0	0
3L	12463065	0	0	0	0	0
3L	12463742	0	0	17	0	17
3L	12471180	0	0	0	0	0
3L	12471570	0	0	0	0	0
3L	12493418	0	0	3	0	3
3L	12494398	0	0	0	0	0
3L	12508254	0	0	0	0	0
3L	12508840	0	0	0	0	0
3L	12509140	0	0	0	0	0
3L	12510503	0	0	0	0	0
3L	12519462	155	0	0	0	155
3L	12519598	127	0	0	0	127
3L	12524172	1	0	0	0	1
3L	12527022	0	0	1	0	1
3L	12529862	0	0	0	0	0
3L	12546839	0	0	0	0	0
3L	12691864	0	0	0	0	0
3L	12731393	0	0	0	0	0
3L	12731797	0	0	0	0	0
3L	12768257	22	0	0	0	22
3L	12826688	0	20	0	0	20
3L	12853773	0	0	108	0	108
3L	12856591	70	0	0	0	70
3L	13007953	0	1	0	0	1
3L	13020448	0	19	0	95	114
3L	13038438	16	0	36	0	52
3L	13194742	0	0	0	0	0
3L	13194835	0	0	0	0	0
3L	13195237	0	0	0	0	0
3L	13195308	0	0	0	0	0
3L	13196156	0	0	0	0	0
3L	13196212	0	0	0	0	0
3L	13218792	0	0	0	0	0
3L	13225212	0	0	0	0	0
3L	13309717	0	0	0	0	0
3L	13312105	0	0	0	0	0
3L	13312111	0	0	0	0	0
3L	13418107	0	7	0	3	10
3L	13435185	0	0	0	14	14
3L	13467599	0	74	0	0	74
3L	13467636	0	75	0	0	75
3L	13467653	0	81	0	0	81
3L	13480590	0	0	56	0	56
3L	13492027	0	0	0	1	1
3L	13494294	2	0	0	0	2
3L	13494298	2	0	0	0	2
3L	13494304	2	0	0	0	2
3L	13494305	0	0	2	0	2
3L	13494355	0	0	0	2	2
3L	13494364	2	0	0	0	2
3L	13494365	0	0	2	0	2
3L	13494372	0	2	0	0	2
3L	13494373	0	2	0	0	2
3L	13494374	2	0	0	0	2
3L	13494390	0	0	3	0	3
3L	13494392	0	3	0	0	3
3L	13494408	0	3	0	0	3
3L	13494438	3	0	0	0	3
3L	13494439	0	3	0	0	3
3L	13494441	4	0	0	0	4
3L	13494445	4	0	0	0	4
3L	13494448	4	0	0	0	4
3L	13494451	3	0	0	0	3
3L	13494457	0	0	3	0	3
3L	13494472	0	0	0	2	2
3L	13494497	2	0	0	0	2
3L	13494498	1	0	0	0	1
3L	13494519	0	3	0	0	3
3L	13494520	0	0	0	3	3
3L	13494596	0	0	3	0	3
3L	13494693	0	0	0	0	0
3L	13494842	0	0	8	0	8
3L	13502410	0	0	0	4	4
3L	13535416	0	0	18	0	18
3L	13600286	0	0	0	0	0
3L	13703883	0	0	0	0	0
3L	13858574	89	0	0	0	89
3L	13859907	0	0	25	0	25
3L	13869566	58	0	0	0	58
3L	13871006	0	0	0	9	9
3L	13888962	0	0	0	1	1
3L	13901738	0	0	0	53	53
3L	13912261	0	0	0	0	0
3L	13919434	0	0	0	19	19
3L	13927002	0	0	0	22	22
3L	13929952	17	0	11	0	28
3L	13933146	56	0	0	0	56
3L	13933176	66	0	0	0	66
3L	13959984	31	1	0	0	32
3L	13962782	0	0	0	4	4
3L	13967324	0	0	0	0	0
3L	13974178	43	0	0	0	43
3L	14000997	0	0	0	18	18
3L	14001118	0	0	0	24	24
3L	14063120	1	0	0	0	1
3L	14066713	77	0	0	0	77
3L	14070532	0	0	0	0	0
3L	14071510	0	0	0	10	10
3L	14084672	0	0	0	0	0
3L	14084674	0	0	0	0	0
3L	14090360	0	0	0	0	0
3L	14090416	0	0	0	0	0
3L	14090417	0	0	0	0	0
3L	14096104	0	0	0	0	0
3L	14096107	0	0	0	0	0
3L	14096112	0	0	0	0	0
3L	14096121	0	0	0	0	0
3L	14096133	0	0	0	0	0
3L	14096136	0	0	0	0	0
3L	14096146	0	0	0	0	0
3L	14097465	0	0	0	0	0
3L	14097466	0	0	0	0	0
3L	14097468	0	0	0	0	0
3L	14097688	0	0	0	0	0
3L	14097689	0	0	0	0	0
3L	14097845	0	0	0	0	0
3L	14097870	0	0	0	0	0
3L	14097874	0	0	0	0	0
3L	14098080	0	0	0	0	0
3L	14098096	0	0	0	0	0
3L	14098097	0	0	0	0	0
3L	14098360	0	0	0	0	0
3L	14098377	0	0	0	0	0
3L	14098378	0	0	0	0	0
3L	14098379	0	0	0	0	0
3L	14100722	0	0	0	0	0
3L	14100724	0	0	0	0	0
3L	14111714	0	0	0	0	0
3L	14112636	0	10	0	0	10
3L	14212209	0	0	44	0	44
3L	14227988	0	0	0	0	0
3L	14235297	0	0	0	1	1
3L	14236740	1	0	0	0	1
3L	14368016	7	0	0	0	7
3L	14426456	0	0	0	0	0
3L	14439493	0	0	0	0	0
3L	14755055	0	0	0	0	0
3L	14764947	66	0	0	0	66
3L	14799253	18	0	7	0	25
3L	14862538	1	0	0	0	1
3L	14882352	0	0	0	0	0
3L	15043222	0	0	0	0	0
3L	15102878	0	0	0	0	0
3L	15102879	0	0	0	0	0
3L	15102886	0	0	0	0	0
3L	15102895	0	0	0	0	0
3L	15102896	0	0	0	0	0
3L	15102897	0	0	0	0	0
3L	15102934	0	0	0	1	1
3L	15102939	1	0	0	0	1
3L	15472441	0	0	0	0	0
3L	15517405	0	0	0	0	0
3L	15532890	0	0	0	0	0
3L	15555171	5	0	0	0	5
3L	15658259	0	0	0	0	0
3L	15658274	0	0	0	0	0
3L	15659522	0	0	0	0	0
3L	15757800	0	0	0	0	0
3L	15893762	0	0	0	18	18
3L	15895755	0	0	0	0	0
3L	16052231	2	0	1	0	3
3L	16111589	0	18	0	56	74
3L	16181016	0	0	0	0	0
3L	16181038	0	0	0	0	0
3L	16181052	0	0	0	0	0
3L	16181053	0	0	0	0	0
3L	16181094	0	0	0	0	0
3L	16182056	0	0	0	0	0
3L	16182169	0	0	0	0	0
3L	16182170	0	0	0	0	0
3L	16186140	0	0	0	0	0
3L	16186145	0	0	0	0	0
3L	16186363	0	0	0	0	0
3L	16254434	0	0	0	0	0
3L	16254435	0	0	0	0	0
3L	16255064	0	0	0	0	0
3L	16255072	0	0	0	0	0
3L	16262552	0	0	0	0	0
3L	16270810	0	0	0	0	0
3L	16291947	0	0	0	0	0
3L	16577155	0	0	0	1	1
3L	16616020	9	0	0	0	9
3L	16616021	0	0	0	9	9
3L	16617760	0	0	0	0	0
3L	16642757	0	1	0	0	1
3L	16645041	0	0	0	0	0
3L	16674672	0	0	0	0	0
3L	16678530	0	124	0	0	124
3L	16686521	0	0	0	0	0
3L	16688610	0	0	0	0	0
3L	16692734	1	0	0	0	1
3L	16728214	0	0	0	0	0
3L	16731471	0	0	0	0	0
3L	16736878	0	0	0	0	0
3L	16758529	0	0	0	0	0
3L	16786895	145	0	0	0	145
3L	16786980	0	0	0	0	0
3L	16908885	1	0	2	0	3
3L	16910270	0	0	3	0	3
3L	16968101	0	0	0	291	291
3L	17075627	0	2	0	4	6
3L	17378242	0	0	0	0	0
3L	17389187	0	0	0	0	0
3L	17425746	0	0	6	0	6
3L	17451133	17	0	0	0	17
3L	17475161	6	0	0	0	6
3L	17597746	0	34	0	0	34
3L	17668401	0	0	0	13	13
3L	17689993	0	0	0	0	0
3L	17726464	0	0	0	0	0
3L	17742206	0	0	0	3	3
3L	17951569	65	0	0	0	65
3L	17979662	0	0	0	0	0
3L	17979744	0	0	0	0	0
3L	18027635	0	0	0	0	0
3L	18087658	0	0	1	0	1
3L	18090225	0	0	0	0	0
3L	18132571	0	0	0	1	1
3L	18181206	0	0	0	0	0
3L	18189120	0	0	0	0	0
3L	18281392	0	0	0	0	0
3L	18281522	0	0	0	0	0
3L	18555038	0	0	0	0	0
3L	18596316	0	0	0	0	0
3L	18670895	0	0	0	92	92
3L	18682575	14	0	0	0	14
3L	18685220	1	1	0	34	36
3L	18685424	0	0	0	55	55
3L	18728861	0	0	0	0	0
3L	18800841	13	0	0	0	13
3L	18819562	0	0	0	12	12
3L	18878588	0	0	0	153	153
3L	18878936	0	0	0	363	363
3L	18897569	0	0	0	6	6
3L	18922609	0	2	0	0	2
3L	18922733	0	5	0	0	5
3L	19052915	0	0	0	0	0
3L	19055200	0	0	0	0	0
3L	19066432	0	0	0	13	13
3L	19067899	0	0	0	21	21
3L	19070611	0	0	0	0	0
3L	19106047	0	0	0	12	12
3L	19110288	0	35	0	0	35
3L	19147008	0	0	0	0	0
3L	19160049	0	0	0	1	1
3L	19283200	0	7	0	128	135
3L	19283264	0	45	0	96	141
3L	19283265	0	8	0	130	138
3L	19341568	0	0	0	33	33
3L	19369627	0	0	0	0	0
3L	19371398	0	0	0	0	0
3L	19399656	0	0	0	1	1
3L	19411978	0	0	0	0	0
3L	19501470	0	0	0	0	0
3L	19513044	0	0	0	0	0
3L	19516477	0	0	0	0	0
3L	19531391	0	0	0	0	0
3L	19542365	0	0	0	68	68
3L	19545728	0	0	6	0	6
3L	19578009	0	2	0	0	2
3L	19618855	0	0	0	1	1
3L	19689767	1142	0	177	0	1319
3L	19689870	118	0	627	0	745
3L	19689871	24	0	713	0	737
3L	19932956	0	0	0	0	0
3L	20035022	0	0	0	0	0
3L	20098494	0	0	0	107	107
3L	20156776	0	5	0	4	9
3L	20156958	0	9	0	16	25
3L	20252103	2	0	6	0	8
3L	20353020	0	0	0	19	19
3L	20379678	60	0	17	0	77
3L	20391933	0	0	0	13	13
3L	20420837	0	0	0	0	0
3L	20427294	0	0	0	13	13
3L	20428234	0	0	0	20	20
3L	20453518	0	0	0	0	0
3L	20465542	0	0	0	0	0
3L	20502571	1	0	0	0	1
3L	20502628	2	0	0	0	2
3L	20503418	2	0	0	0	2
3L	20523500	0	35	0	67	102
3L	20598406	0	11	0	0	11
3L	20598874	0	0	0	16	16
3L	20690411	0	0	0	0	0
3L	20768391	0	11	0	0	11
3L	20773150	70	0	124	0	194
3L	20773190	65	0	111	0	176
3L	20773546	178	0	12	0	190
3L	20773569	157	0	51	0	208
3L	20773589	170	0	25	0	195
3L	20773609	163	0	38	0	201
3L	20773610	145	0	57	0	202
3L	20802315	1	0	0	0	1
3L	20817830	0	0	0	5	5
3L	20820474	0	0	47	0	47
3L	20867520	0	0	0	0	0
3L	20879740	0	0	0	0	0
3L	20885034	0	107	0	0	107
3L	20942629	0	0	0	0	0
3L	20975576	0	0	0	0	0
3L	21072555	125	0	0	0	125
3L	21115651	0	0	0	0	0
3L	21118999	0	0	0	0	0
3L	21130550	0	0	0	0	0
3L	21130556	0	0	0	0	0
3L	21130559	0	0	0	0	0
3L	21130564	0	0	0	0	0
3L	21130610	0	0	0	0	0
3L	21130611	0	0	0	0	0
3L	21130618	0	0	0	0	0
3L	21130621	0	0	0	0	0
3L	21164936	0	0	0	0	0
3L	21179937	0	94	0	0	94
3L	21195648	0	0	0	3	3
3L	21203253	48	0	2	0	50
3L	21204995	7	0	0	0	7
3L	21205002	8	0	0	0	8
3L	21207897	36	0	8	1	45
3L	21210325	57	0	0	0	57
3L	21213292	43	0	36	0	79
3L	21226173	0	0	0	0	0
3L	21309631	0	1	0	0	1
3L	21333937	21	0	43	0	64
3L	21390253	0	0	0	0	0
3L	21390256	0	0	0	0	0
3L	21390260	0	0	0	0	0
3L	21390271	0	0	0	0	0
3L	21390275	0	0	0	0	0
3L	21390282	0	0	0	0	0
3L	21390294	0	0	0	0	0
3L	21390295	0	0	0	0	0
3L	21390303	0	0	0	0	0
3L	21390314	0	0	0	0	0
3L	21391007	0	0	0	0	0
3L	21391234	0	0	0	0	0
3L	21391240	0	0	0	0	0
3L	21644394	0	0	0	0	0
3L	21644396	0	0	0	0	0
3L	21644402	0	0	0	0	0
3L	21696292	1	0	0	0	1
3L	21696294	0	0	0	1	1
3L	21696345	0	0	1	0	1
3L	21696349	0	1	0	0	1
3L	21696352	0	0	0	1	1
3L	21696354	0	0	0	1	1
3L	21696356	0	1	0	0	1
3L	21696357	0	0	1	0	1
3L	21696361	0	1	0	0	1
3L	21696364	0	0	0	1	1
3L	21696375	0	0	0	0	0
3L	21696397	0	1	0	0	1
3L	21696400	0	1	0	0	1
3L	21696404	0	0	1	0	1
3L	21696405	0	0	1	0	1
3L	21696410	0	0	1	0	1
3L	21714311	0	0	0	0	0
3L	21715425	0	0	0	0	0
3L	21717050	0	0	0	0	0
3L	21728957	10	0	0	0	10
3L	21845812	0	0	0	1	1
3L	22132252	0	0	0	0	0
3L	22133068	1	0	0	0	1
3L	22133070	0	0	0	1	1
3L	22169386	0	0	0	0	0
3L	22268084	5	0	3	0	8
3L	22273143	371	0	32	0	403
3L	22273144	392	0	12	0	404
3L	22463672	0	0	0	2	2
3L	22655901	0	0	0	0	0
3L	22731262	1	0	0	0	1
3L	22793765	0	0	0	12	12
3L	22826560	1	0	0	0	1
3L	22827988	2	0	0	0	2
3L	22894950	0	0	0	0	0
3L	22894959	0	0	0	0	0
3L	23022502	26	0	0	0	26
3L	23022517	21	0	6	0	27
3L	23022531	22	0	1	0	23
3L	23022558	10	0	11	0	21
3L	23022565	17	0	5	0	22
3L	23022570	9	0	13	0	22
3L	23022589	9	0	14	0	23
3L	23022624	15	0	1	0	16
3L	23022651	14	0	4	0	18
3L	23022665	11	0	9	0	20
3L	23022696	19	0	3	0	22
3L	23022733	8	0	12	0	20
3L	23022747	11	0	9	0	20
3L	23022860	30	0	0	0	30
3L	23022915	27	0	4	0	31
3L	23023572	19	0	0	0	19
3L	23023737	14	0	2	0	16
3L	23023745	14	0	1	0	15
3L	23023746	13	0	3	0	16
3L	23023752	8	0	6	0	14
3L	23023759	10	0	5	0	15
3L	23023768	5	0	6	0	11
3L	23023772	4	0	10	0	14
3L	23023773	11	0	3	0	14
3L	23023776	13	0	2	0	15
3L	23023778	12	0	3	0	15
3L	23034648	23	0	34	0	57
3L	23035386	59	0	4	0	63
3L	23035498	48	0	10	0	58
3L	23035510	26	0	30	0	56
3L	23036047	72	0	8	0	80
3L	23036053	28	1	51	0	80
3L	23036055	69	0	12	0	81
3L	23036058	2	0	78	0	80
3L	23036059	44	0	36	0	80
3L	23036066	16	0	59	0	75
3L	23036068	42	0	36	0	78
3L	23036071	3	0	76	0	79
3L	23036082	62	0	18	0	80
3L	23036083	76	0	3	0	79
3L	23036084	76	0	3	0	79
3L	23036087	62	1	16	0	79
3L	23036098	66	0	12	0	78
3L	23036101	67	1	12	0	80
3L	23036116	44	0	47	0	91
3L	23036121	72	0	21	0	93
3L	23036453	46	0	18	0	64
3L	23036548	24	0	35	0	59
3L	23036588	34	0	26	0	60
3L	23036631	31	0	36	0	67
3L	23216253	0	0	0	0	0
3L	23228909	0	0	0	0	0
3L	23228910	0	0	0	0	0
3L	23228912	0	0	0	0	0
3L	23228932	0	0	0	0	0
3L	23231321	0	0	1	0	1
3L	23232223	0	0	0	0	0
3L	23241819	1	0	0	0	1
3L	23252714	1	0	0	0	1
3L	23284872	39	0	7	0	46
3L	23286473	94	0	8	0	102
3L	23286550	89	0	18	0	107
3L	23579149	0	0	0	0	0
3L	23742459	4	0	8	0	12
3L	23743265	16	0	3	0	19
3L	23743306	11	0	0	0	11
3L	23796662	0	0	0	0	0
3L	24031604	23	0	11	0	34
3L	24031889	10	0	13	0	23
3L	24031891	14	0	10	0	24
3L	24040526	0	0	0	0	0
3L	24074572	0	0	0	0	0
3L	24074586	0	0	0	0	0
3L	24074603	1	0	0	0	1
3L	24074606	1	0	0	0	1
3L	24074610	1	0	0	0	1
3L	24074617	1	0	0	0	1
3L	24074621	0	0	0	0	0
3L	24074625	1	0	0	0	1
3L	24074665	0	0	0	0	0
3L	24074669	0	0	1	0	1
3L	24074673	0	0	1	0	1
3L	24074677	0	0	1	0	1
3L	24074679	0	0	1	0	1
3L	24074680	0	0	1	0	1
3L	24074682	0	0	0	0	0
3L	24074685	1	0	0	0	1
3L	24074697	1	0	0	0	1
3L	24074700	1	0	0	0	1
3L	24074710	0	0	1	0	1
3L	24074713	0	0	1	0	1
3L	24074747	0	0	1	0	1
3L	24074754	0	0	1	0	1
3L	24074759	1	0	0	0	1
3L	24074986	0	0	0	0	0
3L	24184343	0	0	0	0	0
3L	24184352	0	0	0	0	0
3L	24260884	0	0	0	0	0
3L	24539756	2	0	1	0	3
3L	24574446	0	0	0	0	0
3L	24727794	0	0	0	0	0
3L	24729192	0	0	0	0	0
3L	24729203	0	0	0	0	0
3L	24729209	0	0	0	0	0
3L	24729558	0	0	0	0	0
3L	24734394	0	0	0	0	0
3L	24734409	0	0	0	0	0
3L	24734433	0	0	0	0	0
3L	24734434	0	0	0	0	0
3L	24734444	0	0	0	0	0
3L	24734445	0	0	0	0	0
3L	24734544	1	0	0	0	1
3L	24734545	1	0	0	0	1
3L	24734548	1	0	0	0	1
3L	24734549	1	0	0	0	1
3L	24734550	1	0	0	0	1
3L	24734565	1	0	0	0	1
3L	24734583	1	0	0	0	1
3L	24739737	0	0	0	0	0
3L	24739770	0	0	0	0	0
3L	24739940	0	0	0	0	0
3L	24739953	0	0	0	0	0
3L	25191188	0	0	0	0	0
3L	25404612	0	0	0	0	0
3L	25411101	0	0	0	0	0
3L	25440130	0	0	0	0	0
3L	25487370	0	0	0	0	0
3L	25519478	0	0	0	1	1
3L	25519484	0	0	0	1	1
3L	25519485	0	0	0	1	1
3L	25519514	0	0	0	1	1
3L	25519515	0	0	0	1	1
3L	25519516	0	0	0	1	1
3L	25519519	0	0	0	1	1
3L	25519523	0	0	0	1	1
3L	25519524	0	0	0	1	1
3L	25598311	0	1	0	0	1
3L	25608424	0	2	0	2	4
3L	25608425	0	1	0	3	4
3L	25608436	0	3	0	2	5
3L	25633906	0	1	0	29	30
3L	25633926	0	0	0	27	27
3L	25668383	0	1	0	1	2
3L	25668389	0	1	0	0	1
3L	25668390	0	2	0	0	2
3L	25668438	0	0	0	2	2
3L	25668442	0	2	0	0	2
3L	25668450	0	1	0	0	1
3L	25668451	0	1	0	0	1
3L	25668452	0	1	0	0	1
3L	25668462	0	0	0	0	0
3L	25668464	0	0	0	0	0
3L	25668466	0	0	0	0	0
3L	25668467	0	0	0	0	0
3L	25668501	0	0	0	0	0
3L	25668503	0	0	0	0	0
3L	25668653	0	1	0	0	1
3L	25669834	0	0	0	0	0
3L	25669886	0	0	0	0	0
3L	25669903	0	0	0	1	1
3L	25669904	0	0	0	1	1
3L	25669929	0	0	0	1	1
3L	25669935	0	0	0	1	1
3L	25674685	1	0	1	0	2
3L	25674703	1	0	1	0	2
3L	25674878	1	0	1	0	2
3L	25849333	0	0	0	0	0
3L	25873801	0	0	0	0	0
3L	25920861	0	0	0	0	0
3L	26001042	0	2	0	3	5
3L	26002127	0	4	0	7	11
3L	26002138	0	1	0	8	9
3L	26002140	0	1	0	7	8
3L	26002728	0	0	0	6	6
3L	26003264	0	1	0	8	9
3L	26009778	0	1	0	2	3
3L	26009830	0	1	0	5	6
3L	26012760	0	1	0	1	2
3L	26012768	0	0	0	1	1
3L	26582674	0	0	0	0	0
3L	26594673	0	0	0	0	0
3L	26610401	0	0	0	0	0
3L	26666453	0	0	0	0	0
3L	26667951	0	0	0	0	0
3L	26756592	1	0	0	0	1
3L	27281127	0	0	0	0	0
3L	27281185	0	0	0	0	0
3L	27845559	0	0	0	0	0
3L	27845560	0	0	0	0	0
3L	27845708	0	0	0	0	0
3L	28002470	0	0	0	0	0
3L	28002543	0	0	0	0	0
3L	28002555	0	0	0	0	0
3L	28002560	0	0	0	0	0
3L	28002748	0	0	0	0	0
3L	28002752	0	0	0	0	0
3R	2156963	0	0	0	0	0
3R	3122736	0	0	0	0	0
3R	3122737	0	0	0	0	0
3R	3751950	1	0	3	0	4
3R	4131662	0	0	0	0	0
3R	4185912	15	0	6	0	21
3R	4185926	13	0	10	0	23
3R	4185927	12	0	11	0	23
3R	4185928	20	0	3	0	23
3R	4186013	21	0	1	0	22
3R	4186020	21	0	2	0	23
3R	4186021	23	0	0	0	23
3R	4186029	23	0	0	0	23
3R	4186038	19	0	3	0	22
3R	4186053	17	0	5	0	22
3R	4186057	22	0	1	0	23
3R	4186060	20	0	3	0	23
3R	4186071	19	0	1	0	20
3R	4186077	19	0	0	0	19
3R	4186090	21	0	0	0	21
3R	4186091	18	0	4	0	22
3R	4279033	0	19	0	6	25
3R	4279036	0	18	0	7	25
3R	4279126	0	26	0	6	32
3R	4279127	0	26	0	6	32
3R	4279128	0	22	0	9	31
3R	4297057	89	0	12	0	101
3R	4297067	98	0	4	0	102
3R	4297086	101	0	2	0	103
3R	4297093	96	0	7	0	103
3R	4297095	85	0	14	0	99
3R	4297504	755	0	557	0	1312
3R	4297517	1011	0	243	0	1254
3R	4297518	875	0	397	0	1272
3R	4299218	189	0	19	0	208
3R	4299387	166	0	26	0	192
3R	4299391	121	1	65	0	187
3R	4301117	85	0	13	0	98
3R	4301124	94	0	0	0	94
3R	4301140	70	1	11	0	82
3R	4301142	65	0	21	0	86
3R	4301144	82	1	4	0	87
3R	4301150	44	1	45	1	91
3R	4301158	78	0	22	0	100
3R	4301166	96	0	6	0	102
3R	4301174	104	1	9	0	114
3R	4301182	114	1	11	0	126
3R	4301190	97	0	20	1	118
3R	4301192	100	0	18	1	119
3R	4301196	110	0	13	0	123
3R	4301198	103	0	21	0	124
3R	4301200	103	0	21	0	124
3R	4301206	109	0	15	0	124
3R	4301208	94	1	24	0	119
3R	4301212	86	0	37	0	123
3R	4301214	107	0	21	0	128
3R	4301216	115	0	9	0	124
3R	4301240	112	0	15	0	127
3R	4301244	96	0	29	0	125
3R	4301246	102	0	23	0	125
3R	4301248	116	0	15	0	131
3R	4301250	114	0	16	0	130
3R	4301252	117	0	20	0	137
3R	4301254	144	0	21	0	165
3R	4301258	122	0	46	0	168
3R	4365384	132	0	118	0	250
3R	4365385	20	0	229	0	249
3R	4365474	123	0	142	0	265
3R	4493894	0	2	0	11	13
3R	4656505	48	0	21	0	69
3R	4702574	17	0	11	0	28
3R	4944773	4	0	0	0	4
3R	4965472	82	0	0	0	82
3R	5084900	0	0	0	76	76
3R	5236209	0	0	0	337	337
3R	5236328	0	0	0	0	0
3R	5236329	0	0	0	0	0
3R	5236332	0	0	0	0	0
3R	5236375	0	0	0	529	529
3R	5236378	0	0	0	534	534
3R	5260897	0	0	0	0	0
3R	5260900	0	0	0	0	0
3R	5260901	0	0	0	0	0
3R	5260908	0	0	0	0	0
3R	5260909	0	0	0	0	0
3R	5260910	0	0	0	0	0
3R	5260911	0	0	0	0	0
3R	5260913	0	0	0	0	0
3R	5260914	0	0	0	0	0
3R	5260918	0	0	0	0	0
3R	5260923	0	0	0	0	0
3R	5260926	0	0	0	0	0
3R	5260929	0	0	0	0	0
3R	5260930	0	0	0	0	0
3R	5260931	0	0	0	0	0
3R	5260932	0	0	0	0	0
3R	5260940	0	0	0	0	0
3R	5260941	0	0	0	0	0
3R	5260944	0	0	0	0	0
3R	5260945	0	0	0	0	0
3R	5260946	0	0	0	0	0
3R	5260947	0	0	0	0	0
3R	5260948	0	0	0	0	0
3R	5260949	0	0	0	0	0
3R	5260954	0	0	0	0	0
3R	5260956	0	0	0	0	0
3R	5260957	0	0	0	0	0
3R	5260958	0	0	0	0	0
3R	5260960	0	0	0	0	0
3R	5260961	0	0	0	0	0
3R	5260962	0	0	0	0	0
3R	5260963	0	0	0	0	0
3R	5260964	0	0	0	0	0
3R	5260965	0	0	0	0	0
3R	5260968	0	0	0	0	0
3R	5260969	0	0	0	0	0
3R	5260970	0	0	0	0	0
3R	5260971	0	0	0	0	0
3R	5260972	0	0	0	0	0
3R	5260973	0	0	0	0	0
3R	5260974	0	0	0	0	0
3R	5260976	0	0	0	0	0
3R	5260981	0	0	0	0	0
3R	5260982	0	0	0	0	0
3R	5260984	0	0	0	0	0
3R	5260985	0	0	0	0	0
3R	5260986	0	0	0	0	0
3R	5260987	0	0	0	0	0
3R	5260992	0	0	0	0	0
3R	5260993	0	0	0	0	0
3R	5260994	0	0	0	0	0
3R	5260995	0	0	0	0	0
3R	5260998	0	0	0	0	0
3R	5261005	0	0	0	0	0
3R	5261038	0	0	0	0	0
3R	5261039	0	0	0	0	0
3R	5261045	0	0	0	0	0
3R	5261046	0	0	0	0	0
3R	5261050	0	0	0	0	0
3R	5261052	0	0	0	0	0
3R	5261064	0	0	0	0	0
3R	5261070	0	0	0	0	0
3R	5261071	0	0	0	0	0
3R	5261073	0	0	0	0	0
3R	5268529	9	0	14	0	23
3R	5331180	0	4	0	5	9
3R	5456078	31	0	61	0	92
3R	5510248	0	9	0	45	54
3R	5512061	0	14	0	43	57
3R	5512062	0	12	0	44	56
3R	5579358	20	0	0	0	20
3R	5650231	61	0	44	0	105
3R	5650351	69	1	58	0	128
3R	5686487	5	0	1	0	6
3R	5794759	13	0	0	0	13
3R	5813914	0	0	0	12	12
3R	5835138	2	0	0	0	2
3R	6004380	0	224	0	401	625
3R	6198321	0	0	0	0	0
3R	6410404	0	0	0	0	0
3R	6454240	0	22	0	0	22
3R	6455990	0	13	0	14	27
3R	6456079	0	27	0	0	27
3R	6481790	0	0	0	4	4
3R	6482470	6	0	0	0	6
3R	6483189	1	0	1	0	2
3R	6646984	0	0	28	0	28
3R	6656412	0	0	0	43	43
3R	6825353	0	6	0	13	19
3R	7192775	39	0	264	0	303
3R	7192825	246	0	55	0	301
3R	7472957	0	0	0	5	5
3R	7474763	0	59	0	83	142
3R	7523172	0	0	0	0	0
3R	7527658	0	0	0	0	0
3R	7541970	1	0	0	0	1
3R	7541971	1	0	0	0	1
3R	7578932	0	3	0	0	3
3R	7632065	0	0	0	0	0
3R	7633948	0	0	0	0	0
3R	7857376	0	0	0	0	0
3R	7860890	0	4	0	32	36
3R	7886440	0	2	0	27	29
3R	7959962	0	0	0	1	1
3R	7975631	0	0	0	249	249
3R	8023269	0	30	0	115	145
3R	8025032	0	137	0	0	137
3R	8237633	0	0	0	30	30
3R	8380051	0	6	0	14	20
3R	8380439	0	13	0	8	21
3R	8380442	0	12	0	10	22
3R	8385971	0	25	0	0	25
3R	8386738	0	13	0	29	42
3R	8386758	0	9	0	27	36
3R	8658956	0	0	0	1	1
3R	8659112	0	0	0	0	0
3R	8661419	0	0	0	86	86
3R	8678362	0	0	17	0	17
3R	8736376	0	3	0	22	25
3R	8737810	0	12	0	14	26
3R	8775615	0	0	0	550	550
3R	8788015	0	0	0	2	2
3R	8788344	0	0	0	2	2
3R	8791608	0	1	0	0	1
3R	8795508	0	0	0	1	1
3R	8812828	0	0	0	6	6
3R	8834533	0	0	0	162	162
3R	8836915	0	63	0	23	86
3R	8836926	0	62	0	24	86
3R	8836929	0	51	0	34	85
3R	8837184	0	81	0	39	120
3R	8837191	0	74	0	45	119
3R	8837610	0	71	0	37	108
3R	8851870	0	0	0	0	0
3R	8864798	0	62	0	0	62
3R	8864972	0	0	0	46	46
3R	8867172	0	0	0	1	1
3R	8922284	0	0	0	0	0
3R	8937081	0	0	0	0	0
3R	8952096	0	0	0	0	0
3R	8992964	0	0	0	0	0
3R	9092757	0	0	0	3	3
3R	9094689	0	0	0	4	4
3R	9120444	0	0	0	6	6
3R	9134740	0	0	0	1	1
3R	9147309	0	0	0	2	2
3R	9192083	0	0	0	6	6
3R	9192878	0	0	0	3	3
3R	9195940	0	0	0	2	2
3R	9350774	1	0	0	0	1
3R	9354339	0	0	0	0	0
3R	9385249	0	0	0	1	1
3R	9394121	0	1	0	0	1
3R	9418495	10	0	0	0	10
3R	9418834	6	0	1	0	7
3R	9419410	7	0	7	0	14
3R	9419457	3	0	6	0	9
3R	9421085	0	0	1	0	1
3R	9428183	1	0	0	0	1
3R	9428227	2	0	0	0	2
3R	9428853	1	0	4	0	5
3R	9430861	2	0	2	0	4
3R	9430877	3	0	1	0	4
3R	9448522	198	0	29	1	228
3R	9451570	163	0	0	0	163
3R	9451939	143	0	43	0	186
3R	9455622	0	0	0	23	23
3R	9465643	0	0	0	47	47
3R	9492559	0	0	0	3	3
3R	9525980	0	0	106	0	106
3R	9544703	0	1	0	14	15
3R	9544820	0	0	0	3	3
3R	9591515	49	0	0	0	49
3R	9591859	14	0	0	0	14
3R	9614889	2	0	0	0	2
3R	9666847	0	0	0	0	0
3R	9721112	0	78	0	0	78
3R	9727213	0	51	0	0	51
3R	9729053	0	0	0	85	85
3R	9754511	0	0	0	9	9
3R	9761125	31	0	0	0	31
3R	9769425	75	0	30	0	105
3R	9798395	0	93	0	0	93
3R	9965066	0	0	0	0	0
3R	10029831	0	0	0	0	0
3R	10083460	1	0	0	0	1
3R	10097183	3	0	0	0	3
3R	10194903	35	0	11	0	46
3R	10194972	29	0	12	0	41
3R	10194990	28	0	14	0	42
3R	10195423	266	0	55	2	323
3R	10195426	16	1	305	0	322
3R	10195571	54	0	0	0	54
3R	10195983	188	0	93	0	281
3R	10195984	133	0	159	0	292
3R	10227022	8	0	4	0	12
3R	10228870	74	0	0	0	74
3R	10245424	108	0	26	0	134
3R	10245425	31	0	98	1	130
3R	10305770	25	0	0	0	25
3R	10333913	8	0	0	0	8
3R	10372369	0	0	0	23	23
3R	10391255	3	0	0	0	3
3R	10392923	18	0	0	0	18
3R	10393067	18	0	0	0	18
3R	10394318	14	0	0	0	14
3R	10515812	0	0	0	1	1
3R	10558186	0	0	0	2	2
3R	10584920	0	11	0	48	59
3R	10585180	0	7	0	29	36
3R	10585186	0	5	0	30	35
3R	10766619	19	0	0	0	19
3R	10768515	0	20	0	99	119
3R	10776609	0	0	0	2	2
3R	10782974	0	0	0	40	40
3R	10871792	0	0	0	250	250
3R	11127820	0	0	0	164	164
3R	11193273	0	0	0	0	0
3R	11398476	21	0	15	0	36
3R	11398478	30	0	5	0	35
3R	11450201	0	1	0	0	1
3R	11589338	0	0	0	48	48
3R	11765112	0	5	0	50	55
3R	11801192	0	38	0	47	85
3R	11951530	109	0	37	0	146
3R	11951562	88	0	51	0	139
3R	11953544	276	0	0	0	276
3R	11985293	0	0	0	404	404
3R	11989608	0	0	0	9	9
3R	11994674	0	114	0	0	114
3R	12079394	0	0	0	11	11
3R	12079473	0	0	0	8	8
3R	12096226	21	0	0	0	21
3R	12163774	0	684	0	1	685
3R	12164347	0	134	0	454	588
3R	12215148	6	0	0	0	6
3R	12283052	0	0	0	0	0
3R	12411087	0	0	86	0	86
3R	12416318	42	0	0	0	42
3R	12516932	1	9	0	19	29
3R	12593574	0	1	0	11	12
3R	12593953	0	1	0	18	19
3R	12594802	0	0	0	19	19
3R	12705537	0	0	0	0	0
3R	12741372	0	0	0	0	0
3R	13004750	0	0	79	0	79
3R	13004828	0	0	101	0	101
3R	13018291	0	0	7	0	7
3R	13373289	0	0	1	634	635
3R	13382634	0	0	0	0	0
3R	13399579	0	0	0	254	254
3R	13462029	44	0	0	0	44
3R	13528966	0	0	0	0	0
3R	13663586	232	0	1	0	233
3R	13692592	47	0	51	0	98
3R	13692593	80	0	19	0	99
3R	13725311	0	0	0	0	0
3R	13782016	0	0	1	0	1
3R	13782327	0	0	0	0	0
3R	13959841	368	0	0	0	368
3R	13993445	0	0	0	0	0
3R	14105598	0	21	0	0	21
3R	14108210	0	0	0	12	12
3R	14128425	0	0	43	0	43
3R	14330746	0	53	0	0	53
3R	14363401	0	0	0	0	0
3R	14363405	0	0	0	0	0
3R	14395408	0	52	0	0	52
3R	14409075	0	46	0	0	46
3R	14515193	0	0	0	49	49
3R	14522391	714	0	0	0	714
3R	14623285	0	0	0	74	74
3R	14735962	0	0	0	0	0
3R	14746231	0	0	0	111	111
3R	14746547	0	0	1	208	209
3R	14747108	0	0	0	167	167
3R	14788816	68	0	0	0	68
3R	14809014	0	5	0	0	5
3R	14880381	14	0	0	0	14
3R	14891090	1291	0	0	0	1291
3R	14903154	0	7	0	0	7
3R	14919312	0	0	33	0	33
3R	14996135	0	0	0	0	0
3R	15097165	0	8	0	85	93
3R	15099803	1	0	0	81	82
3R	15287927	0	0	0	0	0
3R	15288163	14	0	0	0	14
3R	15294740	15	0	1	0	16
3R	15296683	602	0	7	0	609
3R	15296695	597	0	4	0	601
3R	15297732	4	0	1	0	5
3R	15298760	3	0	0	0	3
3R	15306860	9	0	0	0	9
3R	15306861	8	0	1	0	9
3R	15384375	14	0	3	0	17
3R	15387222	87	0	46	0	133
3R	15388396	81	0	76	0	157
3R	15392578	151	0	0	0	151
3R	15399446	59	0	98	0	157
3R	15400137	14	0	0	0	14
3R	15400209	9	0	0	0	9
3R	15400211	11	0	0	0	11
3R	15400224	0	0	9	1	10
3R	15401498	0	0	0	122	122
3R	15413254	63	0	114	0	177
3R	15413305	80	1	120	0	201
3R	15413827	178	0	0	0	178
3R	15822468	98	0	20	0	118
3R	15950619	0	0	0	2	2
3R	16003657	55	0	0	0	55
3R	16045954	0	0	0	11	11
3R	16065967	0	1	0	2	3
3R	16087664	0	0	0	0	0
3R	16096668	0	106	0	40	146
3R	16097238	0	46	0	67	113
3R	16302773	18	0	12	0	30
3R	16302775	17	0	13	0	30
3R	16303403	42	0	3	0	45
3R	16303415	38	0	8	0	46
3R	16502786	19	0	0	0	19
3R	16591505	0	0	0	1	1
3R	16633290	108	0	19	0	127
3R	16633369	46	0	39	1	86
3R	16809936	0	0	0	0	0
3R	16827828	0	0	0	0	0
3R	17140246	0	0	0	0	0
3R	17149369	0	0	0	21	21
3R	17502097	0	0	0	0	0
3R	17544578	78	0	34	0	112
3R	17544743	71	0	26	0	97
3R	17750942	0	0	0	7	7
3R	17750957	0	2	0	4	6
3R	17770919	0	0	0	52	52
3R	17771810	0	0	0	63	63
3R	17772922	0	0	0	95	95
3R	17773982	0	13	0	4	17
3R	17774217	0	56	0	20	76
3R	17774401	33	0	0	0	33
3R	17774920	0	0	0	7	7
3R	17775731	0	0	0	18	18
3R	17778660	0	0	0	14	14
3R	17795473	22	0	0	0	22
3R	17796092	12	0	0	0	12
3R	17796780	0	0	0	65	65
3R	17797297	0	0	0	54	54
3R	17799317	0	0	0	10	10
3R	17808359	0	0	0	21	21
3R	17809478	0	0	0	6	6
3R	17852526	46	0	0	0	46
3R	17865673	54	0	0	0	54
3R	17873639	0	59	0	67	126
3R	17874391	0	1	0	121	122
3R	17877415	0	0	0	108	108
3R	17881420	0	78	0	30	108
3R	17881807	0	0	0	115	115
3R	17882765	0	40	0	2	42
3R	17897257	0	4	0	6	10
3R	17905164	0	0	0	48	48
3R	17905999	0	0	0	59	59
3R	17908804	32	0	0	0	32
3R	17938630	0	0	0	0	0
3R	17944246	13	0	0	0	13
3R	17945071	2	0	0	0	2
3R	17945344	2	0	0	0	2
3R	17945752	2	0	0	0	2
3R	17946291	3	0	0	0	3
3R	17947397	36	0	0	0	36
3R	17949372	1	0	0	0	1
3R	17967291	0	0	54	0	54
3R	17967728	22	0	32	0	54
3R	17976866	0	0	1	0	1
3R	17980448	0	0	6	0	6
3R	17986938	1	0	0	0	1
3R	17992257	0	0	0	0	0
3R	17994037	1	0	0	0	1
3R	17994206	0	0	2	0	2
3R	18017356	34	0	0	0	34
3R	18133238	7	0	0	0	7
3R	18199189	0	0	0	7	7
3R	18205263	2	0	0	0	2
3R	18226004	0	0	0	20	20
3R	18236442	33	0	0	0	33
3R	18238159	61	0	0	0	61
3R	18290939	0	0	0	70	70
3R	18355194	0	24	0	9	33
3R	18355198	0	16	0	15	31
3R	18355305	0	17	0	9	26
3R	18360355	0	2	0	2	4
3R	18498021	0	0	0	0	0
3R	18599594	0	0	0	0	0
3R	18674009	7	1	0	0	8
3R	18801700	0	0	0	37	37
3R	18806029	0	4	0	14	18
3R	18824181	0	0	0	0	0
3R	18881308	0	0	0	0	0
3R	18907574	483	0	67	0	550
3R	18907652	162	0	385	0	547
3R	18907675	163	0	354	0	517
3R	18907799	239	0	108	0	347
3R	18907980	334	3	139	0	476
3R	18910005	190	0	7	0	197
3R	18910153	35	0	185	0	220
3R	18970679	224	0	15	0	239
3R	18970692	189	0	37	0	226
3R	18971312	123	0	167	0	290
3R	19081553	0	0	0	0	0
3R	19140149	0	17	0	45	62
3R	19141001	0	17	0	87	104
3R	19218093	0	0	0	2	2
3R	19231096	1	54	1	241	297
3R	19231097	0	81	0	211	292
3R	19231100	0	20	1	270	291
3R	19238197	0	62	0	171	233
3R	19238358	0	53	0	158	211
3R	19238845	0	33	0	152	185
3R	19389278	0	0	0	0	0
3R	19579291	0	0	0	0	0
3R	19637450	0	0	0	42	42
3R	19643921	0	14	0	0	14
3R	19653645	0	78	0	0	78
3R	19660641	0	0	0	0	0
3R	19662383	0	0	32	0	32
3R	19662407	0	0	32	0	32
3R	19734535	0	0	0	0	0
3R	19753763	28	0	67	0	95
3R	19753764	9	0	86	0	95
3R	19763634	26	0	103	0	129
3R	19765660	57	0	28	1	86
3R	19766576	0	0	86	0	86
3R	19836444	0	0	0	1	1
3R	19840656	0	0	0	0	0
3R	19847652	34	0	0	0	34
3R	19848089	18	0	0	0	18
3R	19848545	19	0	0	0	19
3R	19850222	113	0	0	0	113
3R	19901320	0	0	0	191	191
3R	19901682	0	0	0	164	164
3R	19914707	0	0	0	571	571
3R	19977151	0	0	0	0	0
3R	20037752	0	9	1	22	32
3R	20253305	12	0	1	0	13
3R	20253308	12	0	2	0	14
3R	20254800	0	0	0	0	0
3R	20322199	100	0	79	0	179
3R	20323426	87	0	0	0	87
3R	20397317	0	0	0	4	4
3R	20397347	0	0	0	3	3
3R	20397348	0	0	0	3	3
3R	20397350	0	1	0	2	3
3R	20397351	0	1	0	2	3
3R	20397356	0	0	0	3	3
3R	20397361	0	0	0	2	2
3R	20397362	0	0	0	2	2
3R	20397364	0	0	0	2	2
3R	20397502	0	0	0	3	3
3R	20397510	0	2	0	1	3
3R	20397511	0	1	0	2	3
3R	20397525	0	1	0	2	3
3R	20397526	0	1	0	2	3
3R	20397527	0	0	0	3	3
3R	20442288	0	0	0	0	0
3R	20538040	0	2	0	24	26
3R	20964328	1263	1	704	2	1970
3R	20965039	1173	1	704	0	1878
3R	20978916	77	0	8	0	85
3R	20986865	0	0	0	0	0
3R	20993738	73	0	170	0	243
3R	20993841	77	0	173	0	250
3R	20993853	129	0	124	0	253
3R	21010468	69	0	3	0	72
3R	21010472	68	0	4	0	72
3R	21018588	10	0	72	0	82
3R	21018593	72	0	6	0	78
3R	21018596	24	0	55	0	79
3R	21018660	38	0	57	0	95
3R	21018693	7	0	80	0	87
3R	21018789	84	0	4	0	88
3R	21020302	31	0	13	0	44
3R	21020304	35	0	8	0	43
3R	21020562	13	0	27	0	40
3R	21032796	0	0	0	2	2
3R	21034155	0	0	0	0	0
3R	21035203	0	0	0	0	0
3R	21035311	0	0	0	0	0
3R	21036317	0	0	0	1	1
3R	21210519	11	0	0	0	11
3R	21213783	87	0	22	0	109
3R	21216016	59	0	0	0	59
3R	21228047	14	0	36	0	50
3R	21228182	18	0	41	0	59
3R	21268995	0	0	0	198	198
3R	21275768	0	361	0	0	361
3R	21277235	0	7	0	10	17
3R	21297848	352	0	51	0	403
3R	21316786	0	0	0	4	4
3R	21337167	0	6	0	15	21
3R	21360556	0	0	0	0	0
3R	21580556	0	3	0	0	3
3R	21795674	0	0	0	2	2
3R	21866357	0	7	0	0	7
3R	21979019	0	0	0	3	3
3R	22782190	1	0	0	0	1
3R	22784953	18	0	0	0	18
3R	23061604	16	0	0	0	16
3R	23081390	0	0	0	595	595
3R	23092053	0	0	0	1	1
3R	23112549	0	0	0	543	543
3R	23124996	0	15	0	0	15
3R	23124998	0	0	0	15	15
3R	23125099	0	0	0	12	12
3R	23125127	0	0	0	13	13
3R	23125179	0	0	0	14	14
3R	23125191	0	16	0	0	16
3R	23180642	0	0	0	0	0
3R	23183620	0	0	23	0	23
3R	23188969	0	208	0	1	209
3R	23191853	0	145	0	0	145
3R	23200370	0	0	0	14	14
3R	23228940	0	0	0	142	142
3R	23229652	0	0	0	63	63
3R	23229765	0	0	0	97	97
3R	23245868	0	0	0	0	0
3R	23248865	0	0	0	46	46
3R	23252005	0	0	0	0	0
3R	23261644	0	2	0	4	6
3R	23348613	2	0	0	0	2
3R	23348619	2	0	0	0	2
3R	23348769	2	0	0	0	2
3R	23348836	1	0	0	0	1
3R	23349750	1	0	0	0	1
3R	23355233	0	0	0	8	8
3R	23379528	0	0	0	28	28
3R	23662171	0	0	0	0	0
3R	23662433	0	0	0	0	0
3R	23806927	0	0	0	20	20
3R	23807724	0	0	0	26	26
3R	23812871	0	0	0	84	84
3R	23847794	89	0	0	0	89
3R	23848537	45	0	52	0	97
3R	23889222	0	7	0	4	11
3R	23889403	0	0	0	1	1
3R	23903183	0	0	0	43	43
3R	23906410	0	0	0	0	0
3R	23913774	0	0	0	0	0
3R	23930726	0	0	0	121	121
3R	23936205	1	0	0	734	735
3R	23941852	0	0	0	3	3
3R	23954031	0	0	0	32	32
3R	23954205	0	0	0	34	34
3R	23954270	0	0	0	29	29
3R	23975656	5	0	0	0	5
3R	23976395	200	0	0	0	200
3R	23981667	41	0	35	0	76
3R	23982357	160	0	58	0	218
3R	23983504	386	2	22	0	410
3R	23999913	0	0	0	127	127
3R	24000236	0	0	0	153	153
3R	24000858	0	4	0	21	25
3R	24028532	0	0	0	0	0
3R	24028545	0	0	0	0	0
3R	24035862	0	0	0	82	82
3R	24038324	26	0	0	0	26
3R	24051777	229	0	0	0	229
3R	24059369	16	0	1	0	17
3R	24059405	19	0	0	0	19
3R	24063411	14	0	0	0	14
3R	24065016	0	0	0	9	9
3R	24079314	0	0	0	1	1
3R	24080205	0	0	0	0	0
3R	24080856	0	0	0	1	1
3R	24089901	0	2	0	0	2
3R	24094522	0	0	0	4	4
3R	24096044	0	0	0	0	0
3R	24103714	0	40	0	118	158
3R	24115231	0	183	0	0	183
3R	24136443	35	0	0	0	35
3R	24136633	33	0	0	0	33
3R	24136663	25	0	0	0	25
3R	24141432	21	0	0	0	21
3R	24157937	0	0	0	47	47
3R	24162927	0	0	0	24	24
3R	24214769	0	0	0	0	0
3R	24228774	0	18	0	0	18
3R	24235203	2	0	0	0	2
3R	24292106	29	0	0	0	29
3R	24308629	56	0	0	0	56
3R	24309492	82	0	0	0	82
3R	24311331	25	0	27	0	52
3R	24399715	18	0	0	0	18
3R	24401818	0	12	0	18	30
3R	24511651	0	21	0	74	95
3R	24511656	0	31	0	66	97
3R	24512020	0	4	0	10	14
3R	24512901	0	1	0	10	11
3R	24512911	0	1	0	11	12
3R	24600699	0	0	0	0	0
3R	24668815	14	0	0	0	14
3R	24674513	103	0	7	0	110
3R	24675475	16	0	0	0	16
3R	24675663	7	0	59	0	66
3R	24690643	10	0	0	0	10
3R	24691493	85	0	5	0	90
3R	24692577	3	0	3	0	6
3R	24697793	15	0	1	0	16
3R	24706551	22	0	150	0	172
3R	24707423	27	0	60	0	87
3R	24707696	96	0	29	0	125
3R	24707890	126	0	22	0	148
3R	24708326	51	0	18	0	69
3R	24708329	47	0	23	0	70
3R	24708330	48	0	22	0	70
3R	24708356	60	0	16	0	76
3R	24829203	0	0	0	77	77
3R	25026672	29	0	0	0	29
3R	25039627	224	0	1	0	225
3R	25134628	0	0	0	0	0
3R	25136056	48	0	0	0	48
3R	25268354	0	0	1	0	1
3R	25346655	0	0	0	551	551
3R	25516393	0	0	0	0	0
3R	25530500	0	0	0	0	0
3R	25607422	0	0	0	6	6
3R	25680862	84	0	0	0	84
3R	25871448	38	0	0	0	38
3R	25871506	34	0	0	0	34
3R	25871531	31	0	0	0	31
3R	25871712	33	0	0	0	33
3R	25871911	21	0	0	0	21
3R	25965631	227	0	20	0	247
3R	25965643	1	0	251	0	252
3R	26275388	13	0	3	0	16
3R	26344955	0	0	0	1	1
3R	26384361	0	0	0	0	0
3R	26533202	0	2	0	1	3
3R	26533203	0	0	0	3	3
3R	26533204	0	0	0	3	3
3R	26533205	0	0	0	3	3
3R	26544601	0	0	0	0	0
3R	26555239	0	0	101	0	101
3R	26572578	3	0	0	0	3
3R	26593045	11	0	0	0	11
3R	26601314	0	0	78	0	78
3R	26681389	0	0	0	53	53
3R	26698436	0	0	0	194	194
3R	26699744	0	352	0	1	353
3R	26703453	0	0	0	1	1
3R	26706990	0	0	0	1	1
3R	26707060	0	0	0	1	1
3R	26710227	0	0	0	1	1
3R	26710639	0	0	0	0	0
3R	26711278	0	0	0	0	0
3R	26711482	0	0	0	1	1
3R	26722743	0	0	0	48	48
3R	26799601	0	0	0	0	0
3R	26803090	0	0	0	0	0
3R	26839293	0	0	53	0	53
3R	26839692	0	0	62	0	62
3R	26854725	0	0	0	1	1
3R	26869981	0	1	0	929	930
3R	26870035	0	0	0	960	960
3R	26898498	0	0	1	0	1
3R	26922349	0	0	0	0	0
3R	26941648	70	0	0	0	70
3R	26942517	88	0	0	0	88
3R	26950965	0	0	0	412	412
3R	26964540	0	0	0	8	8
3R	26971309	36	0	0	0	36
3R	27006713	0	0	0	0	0
3R	27059393	0	0	0	0	0
3R	27065920	0	0	0	52	52
3R	27065932	0	0	0	49	49
3R	27101403	0	0	0	21	21
3R	27155499	304	0	0	0	304
3R	27159080	66	0	0	0	66
3R	27237462	0	0	0	82	82
3R	27255644	102	0	0	0	102
3R	27260195	0	0	0	58	58
3R	27275221	9	0	1	0	10
3R	27436670	0	0	0	30	30
3R	27581330	0	0	0	2	2
3R	27610850	0	0	0	0	0
3R	27643914	0	31	0	208	239
3R	27669340	88	0	56	0	144
3R	27673172	91	0	99	0	190
3R	27673289	28	1	196	0	225
3R	27674209	0	0	158	0	158
3R	27674284	0	0	182	2	184
3R	27674568	121	0	145	0	266
3R	27674719	201	0	78	0	279
3R	27674736	32	0	233	0	265
3R	27674878	60	0	169	0	229
3R	27674907	99	0	148	0	247
3R	27675074	233	0	65	0	298
3R	27676160	248	0	53	0	301
3R	27676232	120	0	99	0	219
3R	27923909	1	0	0	0	1
3R	27928133	0	0	0	11	11
3R	27949844	114	0	0	0	114
3R	27954914	0	3	0	0	3
3R	27955650	0	0	5	0	5
3R	27956797	10	0	0	0	10
3R	27957947	0	14	0	0	14
3R	27965771	19	0	0	0	19
3R	27965792	19	0	0	0	19
3R	27966580	0	0	14	0	14
3R	27987451	0	0	0	0	0
3R	28077291	0	0	0	0	0
3R	28211257	0	0	0	0	0
3R	28418412	71	0	0	0	71
3R	28598794	0	15	0	21	36
3R	28630348	0	0	0	0	0
3R	28740661	0	0	0	0	0
3R	28755588	0	0	0	0	0
3R	28755612	0	0	0	0	0
3R	28824334	5	0	0	0	5
3R	28825660	0	0	0	70	70
3R	28834732	0	0	0	65	65
3R	28841035	0	1	0	0	1
3R	28842883	0	0	0	0	0
3R	28845314	0	8	0	0	8
3R	28845906	0	0	30	0	30
3R	28874903	35	0	0	0	35
3R	28877734	0	0	0	12	12
3R	28883203	0	0	0	0	0
3R	28893176	0	0	35	0	35
3R	28903133	16	0	0	0	16
3R	28910138	38	0	0	0	38
3R	28925501	0	0	0	56	56
3R	29682986	5	0	3	0	8
3R	29725169	27	0	0	0	27
3R	29809019	0	0	16	0	16
3R	29852709	31	0	0	0	31
3R	29877130	88	0	0	0	88
3R	29877330	33	0	0	0	33
3R	29877364	27	0	0	0	27
3R	29990367	6	0	0	0	6
3R	29991674	0	0	0	24	24
3R	30002686	0	0	0	84	84
3R	30012340	0	0	0	7	7
3R	30012471	0	0	0	4	4
3R	30014618	0	0	0	8	8
3R	30036766	0	0	0	9	9
3R	30040555	22	0	0	0	22
3R	30083131	7	0	0	0	7
3R	30092365	11	0	0	0	11
3R	30103150	42	0	0	0	42
3R	30104256	226	0	0	0	226
3R	30112301	199	0	0	0	199
3R	30113784	67	0	0	0	67
3R	30114780	37	0	0	0	37
3R	30115158	27	0	0	0	27
3R	30199030	0	0	0	1	1
3R	30303048	1	0	0	0	1
3R	30420927	0	0	0	91	91
3R	30774448	0	0	21	0	21
3R	30796901	0	0	0	0	0
3R	31046504	12	0	0	0	12
3R	31160434	4	0	0	0	4
3R	31228686	47	0	28	0	75
3R	31597431	0	58	0	218	276
3R	31597432	0	82	0	190	272
3R	31599016	0	67	0	666	733
3R	31601718	0	163	0	402	565
3R	31601828	0	120	0	683	803
3R	31602191	0	188	1	842	1031
3R	31608331	0	7	0	10	17
3R	31724907	0	0	0	0	0
3R	31837086	15	0	28	0	43
3R	31837089	12	0	34	0	46
3R	31844215	41	0	16	0	57
3R	31844748	49	0	10	0	59
4	55144	0	1	0	0	1
4	76506	0	0	0	0	0
4	86500	0	0	0	0	0
4	100011	19	0	2	0	21
4	100035	5	0	10	0	15
4	100181	1	0	15	0	16
4	100197	11	0	4	0	15
4	100200	13	0	2	0	15
4	100204	8	0	6	0	14
4	100214	10	0	6	0	16
4	100219	4	0	1	1	6
4	100289	15	0	5	0	20
4	100442	40	0	0	0	40
4	100530	29	0	2	0	31
4	100539	31	0	1	0	32
4	100543	15	0	16	0	31
4	100547	29	0	1	0	30
4	100549	10	0	20	0	30
4	100554	19	0	10	0	29
4	100556	28	0	0	0	28
4	100557	14	0	11	0	25
4	100558	22	0	5	0	27
4	100559	20	0	6	0	26
4	100560	8	0	19	0	27
4	100563	3	0	24	0	27
4	100629	6	0	4	0	10
4	101660	11	0	36	0	47
4	102327	22	0	15	0	37
4	102349	15	0	15	0	30
4	113007	61	0	35	0	96
4	126831	0	2	0	0	2
4	126842	0	1	0	1	2
4	128747	0	0	0	0	0
4	182444	0	0	0	0	0
4	182525	0	0	0	2	2
4	191689	0	11	0	16	27
4	191704	0	18	0	15	33
4	191708	0	11	0	22	33
4	192653	0	5	0	18	23
4	192661	0	16	0	7	23
4	192670	0	15	0	11	26
4	192672	0	4	0	22	26
4	192677	0	16	0	11	27
4	192684	0	11	0	20	31
4	192692	0	12	0	18	30
4	192715	0	16	0	18	34
4	192723	0	6	0	24	30
4	192724	0	6	0	24	30
4	213353	12	0	24	0	36
4	213371	30	0	13	0	43
4	214241	21	0	7	0	28
4	234621	1	0	0	0	1
4	234717	0	0	0	0	0
4	234747	0	0	1	0	1
4	234775	1	0	0	0	1
4	234798	1	0	0	0	1
4	235270	2	0	0	0	2
4	235273	3	0	0	0	3
4	235277	3	0	0	0	3
4	235278	3	0	0	0	3
4	235280	3	0	0	0	3
4	235284	3	0	0	0	3
4	235287	2	0	1	0	3
4	235308	7	0	0	0	7
4	235309	6	0	0	0	6
4	235310	7	0	0	0	7
4	235311	6	0	1	0	7
4	235313	4	0	3	0	7
4	235317	4	0	3	0	7
4	235319	5	0	2	0	7
4	235336	6	0	1	0	7
4	235338	7	0	0	0	7
4	235343	6	0	1	0	7
4	235344	7	0	0	0	7
4	235495	5	0	0	0	5
4	235496	4	0	0	0	4
4	235506	5	0	0	0	5
4	265270	21	0	0	0	21
4	265273	22	0	0	0	22
4	292019	0	0	0	0	0
4	292441	0	1	0	0	1
4	294654	0	1	0	0	1
4	295725	0	0	0	1	1
4	304161	0	2	0	0	2
4	328580	0	5	0	11	16
4	339075	0	8	0	11	19
4	340376	0	6	0	4	10
4	340381	0	1	0	10	11
4	340398	0	8	0	7	15
4	341198	0	0	0	15	15
4	341200	0	1	0	14	15
4	343860	0	0	0	0	0
4	351351	0	0	0	4	4
4	351417	0	1	0	3	4
4	356697	0	3	0	0	3
4	356702	0	1	0	1	2
4	356711	0	2	0	0	2
4	356722	0	1	0	1	2
4	356723	0	2	0	0	2
4	356726	0	1	0	1	2
4	356734	0	1	0	1	2
4	356773	0	2	0	0	2
4	357621	0	2	0	0	2
4	357626	0	2	0	0	2
4	357672	0	0	0	1	1
4	357673	0	0	0	0	0
4	367899	5	0	0	0	5
4	403085	0	0	0	0	0
4	446514	106	0	12	1	119
4	446530	108	0	13	0	121
4	448154	30	0	6	0	36
4	448773	24	0	12	0	36
4	449601	67	0	12	0	79
4	449602	63	0	16	0	79
4	449672	58	0	9	0	67
4	449705	63	0	3	0	66
4	449711	57	0	9	0	66
4	449740	49	0	7	0	56
4	449751	42	0	15	0	57
4	449767	47	0	8	0	55
4	454069	80	0	7	0	87
4	454073	76	0	5	0	81
4	454076	62	0	17	0	79
4	454085	61	0	15	0	76
4	455119	8	0	7	0	15
4	455123	11	0	5	0	16
4	455582	14	0	8	0	22
4	455778	16	0	1	0	17
4	459603	14	0	2	0	16
4	459637	16	0	1	0	17
4	476665	1	1	0	15	17
4	476688	0	6	0	7	13
4	476701	0	9	0	3	12
4	476921	0	8	0	6	14
4	520535	0	0	0	0	0
4	541492	0	7	0	25	32
4	541536	0	12	0	17	29
4	541538	0	6	0	23	29
4	541539	0	19	0	8	27
4	541545	0	3	0	25	28
4	541585	0	4	0	23	27
4	541776	0	6	0	21	27
4	541778	0	14	0	11	25
4	541780	0	2	0	24	26
4	541782	0	14	0	10	24
4	541784	0	15	0	11	26
4	541793	29	0	0	0	29
4	541795	0	4	0	25	29
4	541819	0	4	0	17	21
4	541822	0	3	0	15	18
4	541825	0	0	0	18	18
4	541826	0	3	0	15	18
4	541828	0	4	0	13	17
4	541882	0	1	0	21	22
4	541884	0	1	0	22	23
4	541886	0	5	0	19	24
4	541887	0	3	0	21	24
4	541889	0	1	0	22	23
4	541890	0	1	0	23	24
4	560912	33	0	4	0	37
4	560934	37	0	5	0	42
4	561097	28	0	4	0	32
4	563220	8	0	0	0	8
4	563252	6	0	0	0	6
4	563258	6	0	0	0	6
4	563274	5	0	0	0	5
4	563284	5	0	0	0	5
4	563291	0	0	0	0	0
4	563330	0	0	0	0	0
4	563333	0	0	0	0	0
4	563340	0	0	0	0	0
4	563347	0	0	0	0	0
4	563352	0	0	0	0	0
4	563354	0	0	0	0	0
4	563367	0	0	0	0	0
4	563368	0	0	0	0	0
4	563369	0	0	0	0	0
4	563370	0	0	0	0	0
4	563373	0	0	0	0	0
4	563377	0	0	0	0	0
4	563380	0	0	0	0	0
4	563383	0	0	0	0	0
4	563384	0	0	0	0	0
4	563385	0	0	0	0	0
4	563386	0	0	0	0	0
4	563390	0	0	0	0	0
4	563396	0	0	0	0	0
4	563398	0	0	0	0	0
4	563399	0	0	0	0	0
4	563401	0	0	0	0	0
4	563402	0	0	0	0	0
4	563403	0	0	0	0	0
4	563405	0	0	0	0	0
4	563409	0	0	0	0	0
4	563414	0	0	0	0	0
4	563416	0	0	0	0	0
4	563537	0	0	0	0	0
4	579932	9	0	0	0	9
4	579972	9	0	0	0	9
4	579974	8	0	0	0	8
4	579978	8	0	0	0	8
4	579980	9	0	0	0	9
4	602510	0	4	0	5	9
4	612525	11	0	0	0	11
4	636945	0	1	0	1	2
4	638429	0	0	0	13	13
4	653771	0	0	0	0	0
4	654895	0	4	0	15	19
4	654898	0	3	0	16	19
4	659412	0	2	0	34	36
4	667083	19	0	2	0	21
4	667084	11	0	10	0	21
4	667085	15	0	7	0	22
4	667101	14	0	5	0	19
4	667104	13	0	6	0	19
4	668200	20	0	2	0	22
4	668202	10	0	11	0	21
4	686912	39	0	9	0	48
4	686921	36	0	11	0	47
4	686924	34	0	15	0	49
4	686926	42	0	5	0	47
4	686929	28	0	20	0	48
4	686932	25	0	22	0	47
4	686941	42	0	2	0	44
4	686958	36	0	5	0	41
4	686973	31	0	8	0	39
4	686981	40	0	2	0	42
4	687294	16	0	18	0	34
4	688162	38	0	4	0	42
4	725144	0	0	0	0	0
4	743070	26	0	0	0	26
4	744196	1	0	0	0	1
4	744197	1	0	0	0	1
4	744213	1	0	0	0	1
4	744215	0	0	0	0	0
4	744797	1	0	0	0	1
4	744886	0	0	0	0	0
4	744897	0	0	0	0	0
4	745047	0	0	0	0	0
4	745107	0	0	0	0	0
4	747687	37	0	1	0	38
4	747738	28	0	17	0	45
4	767187	116	0	3	0	119
4	767264	107	0	6	0	113
4	823281	0	0	0	0	0
4	856273	0	5	0	13	18
4	856282	0	1	0	16	17
4	856311	0	9	0	9	18
4	856324	0	0	0	17	17
4	856326	0	7	0	9	16
4	856328	0	0	0	18	18
4	856331	0	2	0	14	16
4	856359	0	11	0	6	17
4	856373	0	3	0	15	18
4	857770	0	12	0	3	15
4	858835	0	5	0	4	9
4	858841	0	0	0	10	10
4	860159	0	2	0	10	12
4	860173	0	3	0	13	16
4	860227	0	6	0	9	15
4	860232	0	2	0	12	14
4	860236	0	1	0	13	14
4	874383	0	166	0	90	256
4	878970	0	99	0	242	341
4	879448	0	3	0	36	39
4	879496	0	25	0	5	30
4	879936	0	6	0	63	69
4	882370	0	26	0	34	60
4	889066	0	33	0	20	53
4	895648	0	0	0	0	0
4	896129	0	0	0	1	1
4	896139	0	0	0	0	0
4	896192	0	0	0	0	0
4	897223	0	0	0	0	0
4	897246	0	0	0	0	0
4	897262	0	0	0	0	0
4	897309	0	0	0	0	0
4	908982	0	4	0	12	16
4	980493	0	0	1	0	1
4	980622	2	0	0	0	2
4	999228	12	0	5	0	17
4	1039524	0	3	0	52	55
4	1039649	0	1	0	42	43
4	1040392	0	3	0	61	64
4	1040397	0	18	0	52	70
4	1041214	0	60	0	52	112
4	1041225	0	69	0	59	128
4	1041307	0	75	0	42	117
4	1041381	0	20	0	107	127
4	1041388	0	36	0	92	128
4	1041389	0	11	0	112	123
4	1041395	0	28	0	96	124
4	1041418	0	14	0	107	121
4	1041449	0	19	0	102	121
4	1041451	0	62	0	61	123
4	1041452	0	23	0	100	123
4	1041464	0	4	0	115	119
4	1041465	0	13	0	103	116
4	1041478	0	41	0	68	109
4	1041482	0	14	0	90	104
4	1041483	0	4	0	99	103
4	1041494	0	54	0	48	102
4	1041500	0	11	0	84	95
4	1041514	0	35	0	68	103
4	1041521	0	16	0	86	102
4	1041544	0	28	0	74	102
4	1042206	0	18	0	87	105
4	1042231	0	10	0	118	128
4	1042257	0	35	0	95	130
4	1042367	0	13	1	154	168
4	1042368	0	11	0	156	167
4	1042371	0	65	0	101	166
4	1042502	0	47	0	107	154
4	1042610	0	65	0	76	141
4	1042667	0	17	0	131	148
4	1042794	0	8	0	121	129
4	1042907	0	16	0	84	100
4	1042971	0	9	0	78	87
4	1042975	0	18	0	71	89
4	1045395	0	0	0	0	0
4	1045396	0	0	0	0	0
4	1046984	0	1	0	2	3
4	1046986	0	0	0	3	3
4	1046987	0	0	0	4	4
4	1051636	0	5	0	10	15
4	1052332	0	0	0	0	0
4	1125511	1	0	3	0	4
4	1125515	1	0	3	0	4
4	1125529	1	0	5	0	6
4	1125587	4	0	2	0	6
4	1125632	4	0	1	0	5
4	1126049	1	0	1	0	2
4	1126064	1	0	0	0	1
4	1126065	0	0	1	0	1
4	1126078	1	0	0	0	1
4	1126349	4	0	0	0	4
4	1132912	20	0	7	0	27
4	1132913	29	0	0	0	29
4	1132915	8	0	21	0	29
4	1132917	25	0	3	0	28
4	1132932	22	0	8	0	30
4	1132946	13	0	15	0	28
4	1133654	6	0	30	0	36
4	1133655	23	0	13	0	36
4	1134443	118	0	32	0	150
4	1134452	119	0	19	0	138
4	1134469	85	0	47	0	132
4	1134830	98	0	15	0	113
4	1134861	24	0	83	0	107
4	1134869	92	0	20	0	112
4	1136039	26	0	7	0	33
4	1136068	26	0	2	0	28
4	1137308	2	0	23	0	25
4	1148236	2	0	0	0	2
4	1148466	1	0	4	0	5
4	1168877	5	0	4	0	9
4	1232612	8	0	1	0	9
4	1232942	6	0	0	0	6
4	1234422	9	0	0	0	9
4	1234429	9	0	1	0	10
4	1244706	9	0	8	0	17
4	1244726	11	0	2	0	13
4	1244727	7	0	6	0	13
4	1252829	11	0	21	0	32
4	1252993	33	0	8	0	41
4	1254576	27	0	14	0	41
4	1255125	34	0	2	0	36
4	1255131	25	0	11	0	36
4	1255132	33	0	3	0	36
4	1255154	35	0	6	0	41
4	1255163	39	0	4	0	43
4	1255168	36	0	8	0	44
4	1257070	14	0	7	0	21
4	1257336	13	0	3	0	16
4	1257543	9	0	3	0	12
4	1257984	26	0	7	0	33
4	1260280	3	0	9	0	12
4	1260284	8	0	4	0	12
4	1265107	152	0	174	0	326
4	1267648	3	0	0	0	3
Un_DS483999v1	2471	0	0	0	0	0
Un_DS484083v1	1024	0	0	0	0	0
Un_DS484090v1	1859	0	0	0	0	0
Un_DS484176v1	2586	0	0	0	0	0
Un_DS484511v1	1204	0	0	0	0	0
Un_DS484539v1	1135	0	0	0	0	0
Un_DS484746v1	578	0	0	0	0	0
Un_DS485536v1	813	0	0	0	0	0
Un_DS485605v1	551	0	0	0	0	0
X	514252	0	14	0	30	44
X	514297	0	7	0	41	48
X	514298	0	16	0	34	50
X	516944	0	3	0	49	52
X	516949	0	8	0	41	49
X	516964	0	11	0	40	51
X	923306	0	0	0	82	82
X	923307	0	0	0	86	86
X	924277	0	62	0	56	118
X	1373346	178	0	89	0	267
X	1373528	119	0	87	0	206
X	1373589	130	0	31	0	161
X	1373602	146	0	22	0	168
X	1378095	195	0	55	0	250
X	1378279	128	0	90	0	218
X	1378284	121	0	106	0	227
X	1491577	0	18	0	33	51
X	1676057	0	103	0	13	116
X	1676066	0	38	0	76	114
X	1676597	0	148	0	34	182
X	1690573	0	47	0	97	144
X	1781840	71	0	39	0	110
X	1784005	36	0	47	0	83
X	1784034	48	1	31	0	80
X	1784035	63	0	14	0	77
X	1784036	37	0	42	0	79
X	1785204	120	0	7	0	127
X	1785212	112	0	17	0	129
X	1785216	101	0	26	0	127
X	1785256	102	0	2	0	104
X	1785441	100	0	1	0	101
X	1785444	105	0	3	0	108
X	1785543	103	0	6	0	109
X	1785888	25	0	37	0	62
X	1785903	53	0	6	0	59
X	1786528	107	0	4	0	111
X	1854163	0	0	0	0	0
X	1854164	0	0	0	0	0
X	2078771	0	0	0	53	53
X	2112342	113	0	46	0	159
X	2112355	142	0	19	0	161
X	2112356	121	0	50	0	171
X	2180389	0	0	0	0	0
X	2219688	0	2	0	9	11
X	2376647	0	23	0	17	40
X	2434676	0	2	0	2	4
X	2515228	0	0	0	6	6
X	2625116	0	0	2	0	2
X	2628866	50	0	100	0	150
X	2660761	160	0	0	0	160
X	2667642	1	0	0	0	1
X	2677613	123	0	2	0	125
X	2678338	91	0	5	0	96
X	2678342	75	0	19	0	94
X	3297989	3	0	0	0	3
X	3342781	4	0	0	0	4
X	3343393	25	0	0	0	25
X	3477696	0	0	0	52	52
X	3719089	0	0	0	1	1
X	3730329	0	0	0	0	0
X	3859628	0	325	0	1703	2028
X	3859645	0	439	0	1501	1940
X	3860640	0	252	0	1790	2042
X	3860692	0	282	0	1874	2156
X	3860693	0	989	0	1151	2140
X	3860694	0	223	0	1943	2166
X	3861312	6	154	0	1398	1558
X	3861498	3	349	1	1381	1734
X	3861499	1	335	1	1331	1668
X	3861500	0	179	0	1552	1731
X	3861501	2	1406	0	272	1680
X	3861505	0	1185	1	481	1667
X	3895378	0	2	0	28	30
X	3953264	131	0	62	0	193
X	4102802	0	0	0	0	0
X	4217290	0	0	0	1	1
X	4352383	4	0	0	0	4
X	4356397	38	0	2	0	40
X	4689184	0	0	0	0	0
X	4689563	0	0	0	0	0
X	4701126	0	1	0	188	189
X	4711852	0	0	0	0	0
X	4981377	0	0	0	0	0
X	5087477	0	0	4	0	4
X	5170349	10	0	4	0	14
X	5239523	37	0	2	0	39
X	5251934	1	0	0	58	59
X	5252342	35	0	3	0	38
X	5360710	0	0	0	0	0
X	5396519	21	0	24	0	45
X	5397332	0	0	7	0	7
X	5397347	4	0	4	0	8
X	5397612	5	0	2	0	7
X	5630114	1	309	0	59	369
X	5630195	0	56	0	338	394
X	5630213	0	211	0	192	403
X	5630234	1	319	0	62	382
X	5630342	0	181	0	174	355
X	5630737	0	38	6	289	333
X	5631026	0	126	0	117	243
X	5631035	0	212	0	33	245
X	5631048	0	218	0	46	264
X	5788690	0	0	19	0	19
X	5810061	0	0	0	0	0
X	5963943	0	0	0	0	0
X	5998043	0	1	0	32	33
X	6105139	0	7	0	102	109
X	6107611	0	72	0	218	290
X	6107620	0	159	0	129	288
X	6107716	0	59	0	26	85
X	6108552	0	166	0	65	231
X	6108553	0	205	1	23	229
X	6108712	0	148	0	5	153
X	6108766	0	71	0	121	192
X	6109871	0	33	0	181	214
X	6112645	0	13	0	129	142
X	6115425	0	163	0	24	187
X	6145386	0	17	0	112	129
X	6184321	0	0	0	0	0
X	6531547	0	0	0	0	0
X	6537186	0	0	12	0	12
X	6577785	5	0	0	0	5
X	6790259	0	1	0	4	5
X	7085816	0	83	0	30	113
X	7445827	19	0	10	0	29
X	7698223	0	1	0	0	1
X	7912801	75	0	0	0	75
X	7938121	0	0	0	0	0
X	7987553	0	0	0	0	0
X	8046474	0	1	0	6	7
X	8055921	0	0	0	0	0
X	8055924	0	0	0	0	0
X	8240090	37	0	68	0	105
X	8240161	73	0	38	0	111
X	8247628	242	0	153	0	395
X	8272518	0	3	0	1	4
X	8403319	14	0	14	0	28
X	8409426	0	0	0	18	18
X	8518112	3	0	2	0	5
X	8632440	0	14	0	23	37
X	8649283	0	3	0	1	4
X	8908884	0	2	0	1	3
X	8910271	0	0	0	0	0
X	8917312	11	0	0	0	11
X	8927652	0	0	0	0	0
X	8927665	0	0	0	0	0
X	8941468	1	0	0	0	1
X	8942088	3	0	0	0	3
X	8942812	2	0	0	0	2
X	8966417	5	0	0	0	5
X	9002119	0	0	0	5	5
X	9020223	9	0	37	0	46
X	9020239	24	0	21	0	45
X	9020384	3	0	28	0	31
X	9022297	0	0	0	85	85
X	9022830	77	0	10	0	87
X	9022835	20	0	65	0	85
X	9022869	15	0	48	0	63
X	9022902	51	0	5	0	56
X	9022931	33	0	39	0	72
X	9022942	44	0	25	0	69
X	9022943	60	0	10	0	70
X	9028080	83	0	74	0	157
X	9028091	96	0	64	0	160
X	9037319	0	0	0	0	0
X	9153487	0	183	1	1460	1644
X	9200948	0	0	0	1	1
X	9278576	0	9	0	17	26
X	9340169	0	0	0	1	1
X	9574655	0	47	0	23	70
X	9754490	4	0	12	0	16
X	10016995	0	0	0	1	1
X	10247964	0	5	0	16	21
X	10330625	0	0	0	0	0
X	10356486	183	0	0	0	183
X	10463690	46	0	0	0	46
X	10639732	0	0	0	0	0
X	10709480	55	0	12	0	67
X	10711327	0	0	0	23	23
X	10711351	0	0	0	23	23
X	10746485	112	0	39	0	151
X	10746488	109	0	37	0	146
X	10817179	0	0	0	0	0
X	10835849	0	70	0	19	89
X	10846781	0	39	0	58	97
X	11047667	9	0	4	0	13
X	11047679	12	0	5	0	17
X	11047750	6	0	8	0	14
X	11047753	9	0	6	0	15
X	11048103	3	0	6	0	9
X	11052798	0	179	0	203	382
X	11221249	0	0	0	13	13
X	11221253	0	2	0	11	13
X	11221255	0	0	0	13	13
X	11221259	0	2	0	11	13
X	11221261	0	0	0	12	12
X	11221263	0	0	0	13	13
X	11221265	0	0	0	13	13
X	11221267	0	0	0	13	13
X	11221296	0	1	0	13	14
X	11221308	0	0	0	13	13
X	11221310	0	0	0	14	14
X	11221312	0	0	0	14	14
X	11221318	0	1	0	13	14
X	11221322	0	0	0	13	13
X	11221325	0	4	0	10	14
X	11224387	0	11	0	21	32
X	11330935	81	0	0	0	81
X	11371626	2	0	0	0	2
X	11553315	85	0	0	0	85
X	11575555	8	0	7	0	15
X	11704179	140	0	36	0	176
X	11704188	99	0	65	0	164
X	11812074	0	44	0	45	89
X	11812089	0	46	0	45	91
X	11939698	0	27	0	42	69
X	11939764	0	14	0	38	52
X	11949882	0	28	0	41	69
X	11949883	0	11	0	58	69
X	11954277	0	51	0	12	63
X	11955525	0	5	0	6	11
X	11955561	0	7	0	6	13
X	11964192	0	6	1	23	30
X	11967712	0	11	0	9	20
X	11968032	0	13	0	2	15
X	11968676	0	6	0	36	42
X	11968768	0	32	0	16	48
X	11968969	0	16	0	17	33
X	11970546	0	9	0	32	41
X	11970552	0	4	0	35	39
X	11970556	0	19	0	23	42
X	11971853	0	19	0	13	32
X	11977538	0	13	0	6	19
X	12178407	0	0	0	0	0
X	12234654	2	0	0	0	2
X	12321994	0	0	82	0	82
X	12411368	0	0	0	0	0
X	12446818	24	0	3	0	27
X	12517682	0	9	0	33	42
X	12517716	0	5	0	42	47
X	12530707	0	0	0	0	0
X	12570094	0	9	0	12	21
X	12570147	0	11	0	9	20
X	12610058	0	1	0	55	56
X	12633103	3	0	0	0	3
X	12638680	309	0	49	0	358
X	12670776	0	0	0	0	0
X	12772709	16	0	27	0	43
X	12779207	0	5	0	3	8
X	12836423	0	0	0	0	0
X	12920895	4	0	0	0	4
X	13075382	22	0	62	0	84
X	13326657	0	0	50	0	50
X	13338794	18	0	0	0	18
X	13363027	0	0	0	0	0
X	13363147	0	0	3	0	3
X	13364994	14	1	21	0	36
X	13375332	0	0	3	0	3
X	13713539	41	0	5	0	46
X	13713540	38	0	8	0	46
X	13713557	45	0	6	0	51
X	13713560	43	0	6	0	49
X	13713989	13	0	4	0	17
X	13714028	25	0	0	0	25
X	13714030	20	0	5	0	25
X	13714099	23	0	2	0	25
X	13714108	20	0	5	0	25
X	13915030	0	0	0	0	0
X	13960364	0	0	0	0	0
X	13981405	0	0	0	2	2
X	13988603	0	0	0	2	2
X	14017285	0	0	0	0	0
X	14272086	68	0	41	0	109
X	14272092	3	0	100	0	103
X	14272096	5	0	102	0	107
X	14274268	71	0	25	0	96
X	14791453	1	42	0	103	146
X	14803625	0	0	0	0	0
X	14827027	0	7	0	37	44
X	14827028	0	13	0	31	44
X	14827029	0	14	0	28	42
X	14904567	1141	0	1	1	1143
X	14932507	40	0	11	0	51
X	14996674	17	0	17	0	34
X	14999166	5	0	3	0	8
X	14999641	8	0	4	0	12
X	14999868	6	0	45	0	51
X	14999920	58	0	1	0	59
X	14999924	8	0	50	0	58
X	14999938	46	0	6	0	52
X	15000623	13	0	37	0	50
X	15002265	10	0	17	0	27
X	15004413	16	0	39	0	55
X	15004776	8	0	30	0	38
X	15004857	13	0	37	0	50
X	15004878	42	1	11	0	54
X	15043300	0	0	0	1	1
X	15058391	0	26	0	15	41
X	15098493	82	0	50	0	132
X	15098592	65	0	63	0	128
X	15111879	41	0	87	0	128
X	15112038	43	0	1	0	44
X	15304670	0	0	1	0	1
X	15388627	0	11	0	30	41
X	15392685	0	92	0	16	108
X	15483634	24	0	0	0	24
X	15484167	24	0	1	0	25
X	15501741	0	0	0	0	0
X	15531613	0	0	0	0	0
X	15581889	0	14	0	0	14
X	15897294	337	0	313	0	650
X	15897759	25	0	20	0	45
X	15897789	42	0	4	0	46
X	15897854	31	0	10	0	41
X	15897856	39	0	1	0	40
X	15903965	16	0	125	0	141
X	15919889	96	0	5	0	101
X	15952334	0	1	0	11	12
X	15956689	0	4	0	11	15
X	15956841	0	1	0	12	13
X	15958587	0	81	0	9	90
X	15961105	0	1	0	8	9
X	15961636	0	4	0	11	15
X	15989371	0	6	0	33	39
X	16075853	0	0	0	36	36
X	16339624	50	0	50	0	100
X	16339799	61	0	4	0	65
X	16456420	0	2	0	8	10
X	16456425	0	3	0	8	11
X	16460238	0	2	0	27	29
X	16460589	0	1	0	44	45
X	16460590	0	1	0	44	45
X	16460595	0	6	0	35	41
X	16464719	0	36	0	6	42
X	16466198	0	11	0	7	18
X	16466199	0	13	0	4	17
X	16466203	0	5	0	10	15
X	16466204	0	3	0	12	15
X	16466216	0	0	0	14	14
X	16466692	0	0	0	33	33
X	16468562	0	41	0	7	48
X	16469630	0	14	0	18	32
X	16469631	0	22	0	9	31
X	16471229	0	18	0	15	33
X	16471265	0	14	0	16	30
X	16471290	0	10	0	19	29
X	16471319	0	10	0	14	24
X	16471811	0	10	0	7	17
X	16471812	0	6	0	11	17
X	16471813	0	5	0	9	14
X	16471814	0	6	0	10	16
X	16473609	0	1	0	21	22
X	16473610	0	2	0	20	22
X	16473637	0	15	0	7	22
X	16473638	0	3	0	19	22
X	16475638	0	3	0	33	36
X	16475685	0	0	0	31	31
X	16477558	0	4	0	26	30
X	16481881	0	1	0	12	13
X	16482682	0	16	0	19	35
X	16482683	0	7	0	27	34
X	16482692	0	1	0	33	34
X	16482693	0	18	0	18	36
X	16504240	0	22	0	23	45
X	16504273	0	0	0	43	43
X	16505310	0	0	0	17	17
X	16505550	0	37	0	14	51
X	16509658	0	3	0	49	52
X	16509671	0	3	0	53	56
X	16509684	0	7	0	49	56
X	16511854	0	1	0	11	12
X	16514487	0	0	0	6	6
X	16517164	0	5	0	5	10
X	16518833	0	29	0	19	48
X	16523520	0	0	0	0	0
X	16523529	0	0	0	0	0
X	16523541	0	0	0	0	0
X	16523553	0	0	0	0	0
X	16523556	0	0	0	0	0
X	16523557	0	0	0	0	0
X	16532860	0	0	0	3	3
X	16532866	0	1	0	1	2
X	16562027	0	13	0	49	62
X	16562108	0	12	0	42	54
X	16681534	0	3	0	29	32
X	16839820	0	17	0	41	58
X	16839947	0	0	0	54	54
X	16905030	0	0	0	0	0
X	16915290	5	0	0	0	5
X	17016883	0	3	0	2	5
X	17016898	0	0	0	3	3
X	17017015	0	0	0	2	2
X	17027613	0	0	0	0	0
X	17082644	0	0	0	0	0
X	17097065	48	0	0	0	48
X	17291667	0	0	0	1	1
X	17666685	553	0	0	1	554
X	17674476	0	5	0	2	7
X	17926624	0	14	0	10	24
X	17930651	0	29	0	15	44
X	17930658	0	35	0	7	42
X	17930733	0	21	0	24	45
X	17930890	0	14	0	6	20
X	17930948	0	9	0	9	18
X	17936502	0	3	0	22	25
X	17938011	0	0	0	63	63
X	17941537	0	1	0	18	19
X	17941569	0	0	0	20	20
X	17941570	0	0	0	19	19
X	17942236	0	0	0	13	13
X	17945833	0	1	0	18	19
X	17950057	0	13	0	83	96
X	17952716	0	5	0	87	92
X	17952717	0	5	0	87	92
X	17961411	0	0	0	0	0
X	17981650	0	12	0	16	28
X	17982144	0	14	0	5	19
X	17983811	0	10	0	9	19
X	17983847	0	19	0	2	21
X	17987714	0	0	0	11	11
X	17987788	0	4	0	9	13
X	17987790	0	7	0	6	13
X	17987796	0	3	0	9	12
X	17988376	0	1	0	6	7
X	17989432	0	1	0	11	12
X	17989433	0	10	0	1	11
X	17991679	0	0	0	0	0
X	17991684	0	0	0	0	0
X	17991689	0	0	0	0	0
X	17991690	0	0	0	0	0
X	17991691	0	0	0	0	0
X	18107572	0	0	0	10	10
X	18107970	0	1	0	4	5
X	18170126	14	0	31	0	45
X	18172085	50	0	0	0	50
X	18172108	37	0	0	0	37
X	18173979	24	0	4	0	28
X	18174020	18	0	5	0	23
X	18174056	18	0	5	0	23
X	18177807	5	0	0	0	5
X	18201429	90	0	16	0	106
X	18558815	1	0	2	0	3
X	18901523	2	0	0	0	2
X	19153046	0	0	0	57	57
X	19265115	7	0	15	0	22
X	19265410	1	0	3	0	4
X	19283881	0	28	0	55	83
X	19334465	0	44	0	8	52
X	19334522	0	17	0	31	48
X	19341081	0	0	0	29	29
X	19341084	0	6	0	23	29
X	19341882	0	0	0	66	66
X	19342007	0	34	0	33	67
X	19508447	283	1	47	0	331
X	19545747	0	0	0	1	1
X	19641588	0	32	0	65	97
X	19651650	0	0	0	27	27
X	19727697	12	0	151	0	163
X	19727698	18	0	147	0	165
X	19831888	0	0	0	18	18
X	19835017	0	12	0	19	31
X	19857622	16	0	0	0	16
X	19888186	1	0	0	0	1
X	20330037	0	0	0	0	0
X	20330041	0	0	0	0	0
X	20770084	0	6	0	8	14
X	20773442	0	3	0	4	7
X	20819626	0	0	0	0	0
X	20828303	0	0	0	0	0
X	20828316	0	0	0	0	0
X	20828348	0	0	0	0	0
X	20828364	0	0	0	0	0
X	20828369	0	1	0	0	1
X	20828370	0	1	0	0	1
X	20923843	0	3	0	10	13
X	20924823	0	0	0	2	2
X	21068672	0	0	0	0	0
X	21304740	0	0	0	0	0
X	21629428	0	106	0	153	259
X	21629453	1	114	0	158	273
X	21629508	0	49	0	213	262
X	21629725	0	151	0	125	276
X	21629726	0	98	0	175	273
X	21629727	0	98	0	174	272
X	21629737	0	145	0	139	284
X	22489005	0	0	2	0	2
X	22489022	2	0	0	0	2
X	22499716	55	0	12	0	67
X	22499717	35	0	29	0	64
X	22499732	26	0	40	0	66
X	22502642	234	0	25	0	259
X	22502713	52	0	169	0	221
X	22502735	169	1	35	0	205
X	22980987	0	13	0	165	178
X	22982709	0	370	0	211	581
X	22983936	0	13	0	4	17
X	22984239	0	12	0	18	30
X	22984267	0	3	0	28	31
X	22984352	0	5	0	29	34
X	23024266	2	0	3	0	5
X	23029207	4	0	2	0	6
X	23206974	0	0	0	0	0
Y	400261	0	0	0	0	0
Y	688072	0	0	0	0	0
Y_CP007107v1_random	40134	0	0	0	0	0
Y_DS485767v1_random	101	0	0	0	0	0
