#CHR	POS	Count_A	Count_C	Count_G	Count_T	Good_depth
2R	669894	0	0	0	0	0
2R	927745	0	10	0	36	46
2R	927747	0	12	0	34	46
2R	927763	0	7	0	37	44
2R	927764	0	18	0	27	45
2R	927773	0	19	0	26	45
2R	928819	0	60	0	35	95
2R	928861	0	11	0	72	83
2R	928866	0	37	0	38	75
2R	928867	0	12	0	75	87
2R	946817	0	4	0	19	23
2R	947223	0	0	0	3	3
2R	948265	0	1	0	6	7
2R	949521	0	4	0	2	6
2R	1268441	2	0	6	0	8
2R	1271549	0	0	0	0	0
2R	1362581	0	0	0	0	0
2R	1397455	0	0	0	0	0
2R	1424437	0	0	0	0	0
2R	1424453	0	0	0	0	0
2R	1591958	30	0	1	0	31
2R	1593302	30	0	2	0	32
2R	1593303	31	0	3	0	34
2R	1593310	29	0	4	0	33
2R	1593315	38	0	1	0	39
2R	1593825	20	0	2	0	22
2R	1594032	29	0	2	0	31
2R	1595342	9	0	2	0	11
2R	1595440	9	0	4	0	13
2R	1607075	0	0	2	0	2
2R	1728919	0	0	0	0	0
2R	1738108	0	0	0	0	0
2R	1865062	0	1	0	5	6
2R	1865075	0	1	0	5	6
2R	1865085	0	4	0	2	6
2R	1865087	0	1	0	5	6
2R	1865348	0	1	0	2	3
2R	1865369	0	2	0	1	3
2R	1865574	0	1	0	2	3
2R	1873696	0	0	0	0	0
2R	1891695	0	0	0	0	0
2R	1893555	0	0	0	0	0
2R	1895974	0	0	0	1	1
2R	1905603	0	1	0	1	2
2R	1916341	0	0	0	0	0
2R	1917254	0	0	0	0	0
2R	1958846	0	1	0	0	1
2R	1986061	0	0	0	1	1
2R	1994663	0	0	0	0	0
2R	1994676	0	0	0	0	0
2R	2080600	0	0	0	0	0
2R	2108301	0	0	0	0	0
2R	2191810	0	0	0	0	0
2R	2194077	0	0	0	1	1
2R	2195782	0	0	0	0	0
2R	2202217	0	0	0	0	0
2R	2202225	0	0	0	0	0
2R	2241894	0	0	0	0	0
2R	2246575	0	0	0	0	0
2R	2246585	0	0	0	0	0
2R	2246586	0	0	0	0	0
2R	2246597	0	0	0	0	0
2R	2246605	0	0	0	0	0
2R	2246607	0	0	0	0	0
2R	2246610	0	0	0	0	0
2R	2246614	0	0	0	0	0
2R	2246619	0	0	0	0	0
2R	2246626	0	0	0	0	0
2R	2246628	0	0	0	0	0
2R	2246630	0	0	0	0	0
2R	2246649	0	0	0	0	0
2R	2246650	0	0	0	0	0
2R	2246657	0	0	0	0	0
2R	2246661	0	0	0	0	0
2R	2246666	0	0	0	0	0
2R	2246668	0	0	0	0	0
2R	2246670	0	0	0	0	0
2R	2246672	0	0	0	0	0
2R	2246674	0	0	0	0	0
2R	2246677	0	0	0	0	0
2R	2246691	0	0	0	0	0
2R	2246694	0	0	0	0	0
2R	2246705	0	0	0	0	0
2R	2246718	0	0	0	0	0
2R	2246721	0	0	0	0	0
2R	2246725	0	0	0	0	0
2R	2246749	0	0	0	0	0
2R	2246751	0	0	0	0	0
2R	2246758	0	0	0	0	0
2R	2247749	0	0	0	0	0
2R	2256918	0	1	0	1	2
2R	2257284	0	0	0	2	2
2R	2257289	0	0	0	1	1
2R	2257295	0	0	0	2	2
2R	2257742	0	0	0	0	0
2R	2257793	0	0	0	0	0
2R	2257825	0	0	0	0	0
2R	2257846	0	0	0	0	0
2R	2260195	0	0	0	12	12
2R	2260208	0	0	0	17	17
2R	2260246	0	0	0	15	15
2R	2260647	0	1	0	5	6
2R	2487897	0	0	0	0	0
2R	2487913	0	0	0	0	0
2R	2495761	0	2	0	21	23
2R	2496768	0	11	0	37	48
2R	2496780	0	18	0	27	45
2R	2498338	0	2	0	8	10
2R	2498339	0	0	0	10	10
2R	2498347	0	6	0	5	11
2R	2498348	0	3	0	8	11
2R	2498350	0	2	0	8	10
2R	2498351	0	3	0	7	10
2R	2498353	0	3	0	7	10
2R	2498356	0	5	0	4	9
2R	2498359	0	0	0	8	8
2R	2498363	0	5	0	3	8
2R	2498364	0	3	0	5	8
2R	2517609	0	0	0	2	2
2R	2519999	0	5	0	16	21
2R	2554231	0	0	0	1	1
2R	2554519	0	2	0	4	6
2R	2554530	0	1	0	3	4
2R	2562370	0	4	0	2	6
2R	2562467	0	1	0	4	5
2R	2563510	0	0	0	3	3
2R	2640746	0	0	0	0	0
2R	2820914	0	0	0	0	0
2R	2821043	0	0	0	0	0
2R	2822225	0	0	0	1	1
2R	2822367	0	0	0	0	0
2R	2822866	0	0	0	2	2
2R	2822867	0	0	0	2	2
2R	2822874	0	0	0	2	2
2R	2822875	0	0	0	0	0
2R	2822877	0	0	0	2	2
2R	2822880	0	0	0	2	2
2R	2822883	0	0	0	2	2
2R	2822884	0	0	0	2	2
2R	2822887	0	0	0	2	2
2R	2822888	0	0	0	2	2
2R	2822893	0	0	0	2	2
2R	2822941	0	0	0	3	3
2R	2822942	0	0	0	2	2
2R	2822956	0	0	0	2	2
2R	2822957	0	0	0	3	3
2R	2822958	0	0	0	3	3
2R	2822961	0	0	0	3	3
2R	2822991	0	0	0	3	3
2R	2822995	0	0	0	2	2
2R	2822996	0	0	0	3	3
2R	2822997	0	0	0	3	3
2R	2823003	0	0	0	3	3
2R	2823005	0	0	0	2	2
2R	2823006	0	0	0	3	3
2R	2823007	0	0	0	3	3
2R	2823097	0	0	0	2	2
2R	2823428	0	1	0	1	2
2R	2823645	0	0	0	3	3
2R	2823852	0	0	0	0	0
2R	2831098	0	0	0	1	1
2R	2831110	0	1	0	0	1
2R	2832245	0	0	0	1	1
2R	2843105	0	0	0	3	3
2R	2843112	0	1	0	2	3
2R	2843113	0	1	0	2	3
2R	2843121	0	1	0	2	3
2R	2843122	0	0	0	3	3
2R	2843124	0	1	0	2	3
2R	2843130	0	1	0	2	3
2R	2846308	0	0	0	1	1
2R	2954347	0	0	0	0	0
2R	2954369	0	0	0	0	0
2R	2954754	0	0	0	0	0
2R	2970910	0	0	0	0	0
2R	3104182	0	0	0	0	0
2R	3190285	5	0	2	0	7
2R	3919432	0	2	0	0	2
2R	3932880	0	0	0	0	0
2R	3941840	0	1	0	1	2
2R	4052078	1	0	0	0	1
2R	4052143	1	0	0	0	1
2R	4052192	0	0	1	0	1
2R	4052205	0	0	0	0	0
2R	4052208	0	0	0	0	0
2R	4052224	0	0	0	0	0
2R	4052238	0	0	0	0	0
2R	4052252	0	0	0	0	0
2R	4052268	0	0	0	0	0
2R	4052279	0	0	0	0	0
2R	4220796	0	0	0	0	0
2R	4350268	0	0	0	0	0
2R	4350386	0	0	0	0	0
2R	4367099	0	0	0	0	0
2R	4397570	0	0	0	0	0
2R	4397571	0	0	0	0	0
2R	4397577	0	0	0	0	0
2R	4397580	0	0	0	0	0
2R	4397583	0	0	0	0	0
2R	4397588	0	0	0	0	0
2R	4397601	0	0	0	0	0
2R	4397632	0	0	0	0	0
2R	4397638	0	0	0	0	0
2R	4397643	0	0	0	0	0
2R	4397645	0	0	0	0	0
2R	4397646	0	0	0	0	0
2R	4397658	0	0	0	0	0
2R	4407456	0	0	0	0	0
2R	4407479	0	0	0	1	1
2R	4470411	0	0	0	0	0
2R	4598137	4	0	1	0	5
2R	4610290	0	0	0	0	0
2R	4610327	2	0	1	0	3
2R	4610328	1	0	2	0	3
2R	4610335	3	0	0	0	3
2R	4610338	2	0	1	0	3
2R	4610340	2	0	1	0	3
2R	4610343	3	0	0	0	3
2R	4610344	1	0	2	0	3
2R	4749085	7	0	1	0	8
2R	4787711	0	16	0	86	102
2R	4790435	0	0	0	0	0
2R	4795353	0	0	0	0	0
2R	5027097	0	0	0	0	0
2R	5068277	0	0	0	0	0
2R	5069358	0	0	0	1	1
2R	5069359	0	0	0	1	1
2R	5069360	0	0	0	1	1
2R	5119406	0	11	0	12	23
2R	5120152	0	6	0	7	13
2R	5124254	0	2	0	3	5
2R	5127276	0	2	0	8	10
2R	5211451	0	0	0	0	0
2R	5302757	0	0	0	0	0
2R	5320850	5	0	1	0	6
2R	5337012	0	0	0	0	0
2R	5495400	0	0	0	8	8
2R	5503750	0	0	0	0	0
2R	5503767	0	0	0	0	0
2R	5503911	0	0	0	0	0
2R	5503915	0	0	0	0	0
2R	5504022	0	0	0	0	0
2R	5504026	0	0	0	0	0
2R	5504425	0	0	0	0	0
2R	5504526	0	0	0	0	0
2R	5505677	0	0	0	0	0
2R	5505735	0	0	0	0	0
2R	5505798	0	0	0	0	0
2R	5505800	0	0	0	0	0
2R	5505852	0	0	0	0	0
2R	6031677	0	2	0	0	2
2R	6039689	0	14	0	15	29
2R	6174962	347	0	0	0	347
2R	6571523	0	0	0	0	0
2R	6725344	0	0	0	32	32
2R	6733080	0	5	0	50	55
2R	6733220	0	1	0	35	36
2R	6817728	7	0	8	0	15
2R	6927455	0	5	0	43	48
2R	7130316	0	0	0	16	16
2R	7401894	0	0	0	1	1
2R	7501178	19	0	78	0	97
2R	7502188	7	0	34	0	41
2R	7502199	16	0	21	0	37
2R	7664923	26	0	0	0	26
2R	7813863	74	0	75	0	149
2R	8100701	71	0	25	0	96
2R	8144501	0	2	0	0	2
2R	8464487	221	0	1	0	222
2R	8482655	0	0	0	19	19
2R	8511471	0	0	0	0	0
2R	8616059	157	0	0	0	157
2R	8618670	306	0	0	0	306
2R	8696454	15	0	1	0	16
2R	8876533	75	0	6	0	81
2R	8876790	76	0	10	0	86
2R	8877577	73	0	19	0	92
2R	8883706	6	0	86	0	92
2R	8883745	57	0	46	0	103
2R	8885231	82	0	16	0	98
2R	8885377	72	0	29	0	101
2R	8903673	1559	0	104	0	1663
2R	8903674	1415	0	162	1	1578
2R	8903680	1318	0	388	1	1707
2R	8912445	0	0	0	4	4
2R	9100226	19	0	0	0	19
2R	9110821	6	0	0	0	6
2R	9119427	23	0	0	0	23
2R	9120392	52	0	19	0	71
2R	9158865	0	0	0	36	36
2R	9168104	0	0	0	59	59
2R	9171291	0	0	0	43	43
2R	9171360	0	0	0	43	43
2R	9191664	0	0	0	136	136
2R	9229669	0	35	0	214	249
2R	9229804	0	124	1	477	602
2R	9229936	0	201	0	389	590
2R	9232371	0	0	0	20	20
2R	9234514	0	292	0	243	535
2R	9234519	0	337	0	182	519
2R	9311068	1	7	0	96	104
2R	9312080	0	27	0	49	76
2R	9312087	0	18	0	59	77
2R	9312091	0	7	0	65	72
2R	9312092	33	13	0	27	73
2R	9312093	0	6	0	68	74
2R	9312094	0	6	0	68	74
2R	9328201	0	1	0	2	3
2R	9344191	0	0	0	7	7
2R	9344213	0	4	0	2	6
2R	9345714	0	1	0	5	6
2R	9369253	0	0	0	1	1
2R	9408179	0	5	0	2	7
2R	9440747	0	83	1	12	96
2R	9534930	180	1	73	0	254
2R	9534943	254	0	19	0	273
2R	9539059	0	94	0	156	250
2R	9542736	0	4	0	1	5
2R	9542851	0	0	0	5	5
2R	9592745	1	0	0	0	1
2R	9598728	12	0	0	0	12
2R	9599645	0	0	0	0	0
2R	9619360	0	0	0	2	2
2R	9633098	0	0	0	2	2
2R	9721527	0	1	0	4	5
2R	9723564	0	3	0	44	47
2R	9739197	0	0	0	0	0
2R	9753896	1158	0	61	0	1219
2R	9817692	0	0	0	30	30
2R	9819309	0	6	0	22	28
2R	9819328	0	4	0	25	29
2R	9819477	0	0	0	26	26
2R	9819490	0	5	0	20	25
2R	9884160	0	20	0	163	183
2R	9927725	0	0	0	0	0
2R	10011276	0	0	0	1	1
2R	10091619	15	0	0	0	15
2R	10108800	827	1	435	0	1263
2R	10108801	896	0	354	0	1250
2R	10108802	1003	0	239	0	1242
2R	10222721	0	1	0	0	1
2R	10278408	13	0	0	0	13
2R	10279089	18	0	0	0	18
2R	10280883	31	0	35	0	66
2R	10280988	30	0	52	0	82
2R	10285619	118	0	0	1	119
2R	10321544	17	0	0	0	17
2R	10327175	0	23	0	12	35
2R	10330783	0	2	0	6	8
2R	10330787	0	6	0	3	9
2R	10330795	0	2	0	8	10
2R	10330796	0	0	0	10	10
2R	10330801	0	4	0	6	10
2R	10330802	0	4	0	6	10
2R	10336774	0	45	0	25	70
2R	10378403	0	0	0	0	0
2R	10378432	0	0	0	0	0
2R	10378433	0	0	0	0	0
2R	10392192	0	0	0	9	9
2R	10393990	0	0	0	1	1
2R	10472135	0	178	0	113	291
2R	10531606	0	1	0	6	7
2R	10540485	0	0	0	1	1
2R	10611461	149	0	16	0	165
2R	10611464	145	0	24	0	169
2R	10706747	12	0	2	0	14
2R	10783584	0	0	0	0	0
2R	10785766	0	4	0	0	4
2R	10785846	0	4	0	0	4
2R	10788717	0	0	1	0	1
2R	10789955	1	0	1	0	2
2R	10815342	74	0	0	0	74
2R	10837913	0	511	0	0	511
2R	10840470	0	125	0	25	150
2R	10855471	0	0	0	0	0
2R	11148789	0	22	0	28	50
2R	11229833	0	0	0	154	154
2R	11293045	0	16	0	47	63
2R	11447601	70	0	339	0	409
2R	11447607	13	0	421	0	434
2R	11447617	74	1	333	0	408
2R	11447623	94	0	328	0	422
2R	11447933	495	0	0	0	495
2R	11447935	457	0	36	0	493
2R	11447987	310	0	208	0	518
2R	11450317	239	0	239	0	478
2R	11450318	246	0	235	0	481
2R	11603464	0	0	0	0	0
2R	11635584	0	0	0	0	0
2R	11635585	0	0	0	0	0
2R	11635587	0	0	0	0	0
2R	11635588	0	0	0	0	0
2R	11671280	0	0	0	2	2
2R	11779856	0	0	1	0	1
2R	11827392	0	0	0	9	9
2R	11845525	45	0	8	0	53
2R	11893047	13	0	0	0	13
2R	11990709	33	0	8	0	41
2R	12024356	0	1	0	0	1
2R	12025551	0	4	0	2	6
2R	12025588	0	4	0	0	4
2R	12265428	6	0	0	0	6
2R	12269039	7	0	2	0	9
2R	12328060	52	0	0	0	52
2R	12328068	57	0	0	0	57
2R	12328073	55	0	0	0	55
2R	12329738	1	0	0	0	1
2R	12350262	2	0	1	0	3
2R	12448654	112	0	28	0	140
2R	12448686	90	0	70	0	160
2R	12448723	143	0	60	0	203
2R	12448779	117	0	118	0	235
2R	12469039	6	0	0	0	6
2R	12470834	20	0	0	0	20
2R	12489327	0	0	0	102	102
2R	12648195	0	0	0	4	4
2R	12754897	0	5	0	0	5
2R	12758582	65	1	106	0	172
2R	12800608	7	0	30	0	37
2R	12800859	20	0	10	0	30
2R	12921246	233	0	149	0	382
2R	12921325	293	0	170	0	463
2R	12921326	363	0	92	0	455
2R	13437401	0	0	0	19	19
2R	13517261	0	16	0	209	225
2R	13517274	0	87	0	125	212
2R	13517275	0	151	0	53	204
2R	13517347	0	46	0	127	173
2R	13580366	2	0	0	0	2
2R	13747628	6	0	47	0	53
2R	13748897	0	0	55	0	55
2R	13809071	42	0	10	0	52
2R	13809547	25	0	125	0	150
2R	13809607	68	0	80	0	148
2R	13809962	102	0	102	0	204
2R	13810199	102	0	97	0	199
2R	13817109	157	0	61	0	218
2R	13817124	170	1	14	0	185
2R	13817379	32	0	261	0	293
2R	13823895	0	0	2	81	83
2R	13846257	10	0	0	0	10
2R	13858942	0	0	0	0	0
2R	13885952	0	0	0	129	129
2R	13886458	0	25	0	66	91
2R	13887556	0	71	0	44	115
2R	13893580	0	7	0	67	74
2R	13893934	0	37	0	30	67
2R	13916837	0	0	0	0	0
2R	13974052	0	0	0	75	75
2R	14062507	0	20	0	76	96
2R	14062651	0	48	0	34	82
2R	14062768	0	28	0	78	106
2R	14062771	0	56	0	52	108
2R	14062774	0	9	0	97	106
2R	14149035	0	0	0	88	88
2R	14152423	0	4	0	0	4
2R	14153104	0	1	0	0	1
2R	14171351	24	0	0	0	24
2R	14172781	306	0	48	0	354
2R	14178731	189	0	41	0	230
2R	14182106	88	0	18	0	106
2R	14215739	0	1	0	0	1
2R	14297994	322	0	66	0	388
2R	14331618	1	0	0	0	1
2R	14334547	0	0	0	0	0
2R	14355520	28	0	19	0	47
2R	14361978	0	8	0	0	8
2R	14507629	51	0	0	0	51
2R	14538499	0	0	0	0	0
2R	14555183	0	0	0	0	0
2R	14740426	0	6	0	277	283
2R	14741592	0	175	0	134	309
2R	14742174	0	31	0	423	454
2R	14742210	0	148	0	303	451
2R	14742223	0	101	0	335	436
2R	14742241	1	363	0	76	440
2R	14742359	0	1	0	449	450
2R	14756598	418	0	0	0	418
2R	14762018	0	119	0	123	242
2R	14971913	0	0	126	0	126
2R	15264046	0	42	0	46	88
2R	15264051	0	27	0	59	86
2R	15264096	0	61	0	33	94
2R	15264743	0	31	0	61	92
2R	15415679	24	0	0	0	24
2R	15456269	5	0	4	0	9
2R	15460575	17	0	1	0	18
2R	15460578	13	0	3	0	16
2R	15516140	0	4	0	80	84
2R	15518712	0	41	0	103	144
2R	15765728	0	0	0	25	25
2R	15766457	0	0	0	18	18
2R	15772754	0	0	0	3	3
2R	15772755	0	0	0	3	3
2R	15775053	1	2	0	19	22
2R	15777061	0	8	0	2	10
2R	15779915	0	1	0	1	2
2R	15779918	0	0	0	2	2
2R	15779987	0	2	0	1	3
2R	15779998	0	0	0	3	3
2R	15786556	0	0	0	0	0
2R	15809225	0	0	0	2	2
2R	15871835	0	61	0	36	97
2R	15872366	0	128	0	28	156
2R	15980167	0	0	0	4	4
2R	16336488	15	0	1	0	16
2R	16432544	17	0	0	0	17
2R	16534056	0	0	0	0	0
2R	16576409	0	87	0	0	87
2R	16647491	78	0	10	0	88
2R	16647492	17	0	72	0	89
2R	16647565	72	0	6	0	78
2R	16647597	71	0	7	0	78
2R	16647631	13	0	68	0	81
2R	16650664	65	0	1	0	66
2R	16650669	66	0	0	0	66
2R	16650728	63	0	0	0	63
2R	16650742	79	0	1	0	80
2R	16650776	55	0	15	0	70
2R	16650779	64	0	7	0	71
2R	16650790	43	1	32	0	76
2R	16650805	61	0	13	0	74
2R	16650890	67	0	7	0	74
2R	16762451	0	0	0	1	1
2R	16765101	0	0	0	21	21
2R	16917584	0	0	0	0	0
2R	16932924	15	0	0	0	15
2R	17222715	0	0	0	0	0
2R	17364649	7	0	2	0	9
2R	17374869	19	0	24	0	43
2R	17375028	48	0	17	0	65
2R	17375029	54	0	7	0	61
2R	17375057	25	0	36	0	61
2R	17375058	32	0	27	0	59
2R	17377109	27	0	73	0	100
2R	17377110	33	0	70	0	103
2R	17377122	39	0	60	0	99
2R	17377125	59	0	37	2	98
2R	17377403	55	0	26	0	81
2R	17701194	0	0	0	0	0
2R	18020907	0	0	0	0	0
2R	18134284	0	0	0	9	9
2R	18145289	4	0	0	0	4
2R	18167781	174	0	0	0	174
2R	18173890	31	1	14	0	46
2R	18281192	0	0	0	104	104
2R	18356868	0	0	0	16	16
2R	18518047	12	0	1	0	13
2R	18518048	8	0	6	0	14
2R	18720854	0	0	0	0	0
2R	18743376	0	0	0	0	0
2R	18865057	0	0	0	0	0
2R	18998450	10	0	1	0	11
2R	19006082	73	0	36	0	109
2R	19006586	2	0	0	0	2
2R	19138221	0	0	0	2	2
2R	19139754	140	0	0	0	140
2R	19179174	8	0	1	0	9
2R	19223379	59	0	20	0	79
2R	19223636	77	0	73	0	150
2R	19225658	113	1	51	0	165
2R	19303685	63	0	21	0	84
2R	19326309	0	23	0	25	48
2R	19525936	0	0	0	16	16
2R	19566903	0	1	0	22	23
2R	19625834	0	0	0	0	0
2R	19727230	0	0	0	0	0
2R	20424540	80	0	0	0	80
2R	20658504	0	0	15	0	15
2R	21145178	502	0	49	0	551
2R	21315686	168	0	49	0	217
2R	21334960	11	0	17	0	28
2R	21480214	0	16	0	53	69
2R	21557174	36	0	34	0	70
2R	21620849	0	48	0	38	86
2R	21621075	0	31	0	27	58
2R	21653466	45	0	66	0	111
2R	21851363	0	0	0	0	0
2R	22175545	30	0	0	0	30
2R	22227209	0	0	0	50	50
2R	22391510	38	0	94	0	132
2R	22564373	0	39	0	92	131
2R	22564377	0	37	0	88	125
2R	22568445	0	0	0	0	0
2R	22573070	0	0	0	0	0
2R	22587796	0	0	0	0	0
2R	22637905	68	0	0	0	68
2R	22673075	27	0	0	0	27
2R	22746263	0	3	0	7	10
2R	23381950	0	0	0	37	37
2R	23598132	22	0	1	0	23
2R	23804970	0	0	0	0	0
2R	23838782	38	0	4	0	42
2R	23844274	0	0	0	66	66
2R	23867196	0	0	0	371	371
2R	24006102	0	2	0	80	82
2R	24006115	0	0	0	70	70
2R	24006555	0	78	0	15	93
2R	24046125	0	0	0	1	1
2R	24050977	48	0	21	0	69
2R	24051555	62	0	9	0	71
2R	24218949	0	0	0	0	0
2R	24332337	0	0	0	1	1
2R	24384812	0	81	0	16	97
2R	24419247	0	177	0	14	191
2R	24419250	0	172	0	16	188
2R	24500965	0	0	0	1	1
2R	24512318	0	35	0	116	151
2R	24882682	131	0	13	1	145
2R	24882751	132	0	41	0	173
2R	24885850	119	0	17	0	136
2R	24904717	148	0	17	0	165
2R	24910398	188	0	105	0	293
2R	24910568	173	0	73	0	246
2R	24910752	150	0	28	0	178
2R	24910775	35	0	138	0	173
2R	24910814	120	0	108	0	228
2R	24910823	102	0	129	0	231
2R	24911061	76	0	123	0	199
2R	24911109	82	0	123	0	205
2R	24912004	116	0	24	0	140
2R	24912848	31	0	193	0	224
2R	24912923	244	0	0	0	244
2R	24914689	168	0	39	0	207
2R	24914702	56	0	143	0	199
2R	24914794	43	0	109	0	152
2R	24914829	145	0	23	0	168
2R	24914858	17	0	196	0	213
2R	24914859	202	0	16	0	218
2R	24914864	72	0	151	0	223
2R	24914865	94	0	135	0	229
2R	24914874	113	0	124	1	238
2R	24919093	198	0	35	0	233
2R	24920153	112	0	2	0	114
2R	24995597	0	26	0	78	104
2R	24995857	0	49	0	76	125
2R	25255069	44	0	7	0	51
2R	25255079	27	0	22	0	49
2R	25255082	20	0	31	0	51
2R	25255913	75	0	18	0	93
2R	25256658	16	0	20	0	36
2R	25257110	40	0	6	0	46
2R	25257267	34	0	36	0	70
2R	25257297	53	0	14	0	67
2R	25257312	16	0	44	0	60
2R	25257313	10	0	47	1	58
2R	25257314	28	0	33	0	61
2R	25257317	38	0	24	0	62
2R	25257328	31	0	25	0	56
2R	25257336	47	0	8	0	55
2R	25257337	39	0	12	0	51
2R	25257342	13	0	46	0	59
2R	25257343	16	0	43	0	59
2R	25257375	75	0	1	0	76
2R	25257376	63	0	9	0	72
2R	25257377	47	0	31	0	78
2R	25257383	40	0	38	0	78
2R	25257388	50	0	26	0	76
2R	25257391	56	0	26	0	82
2R	25257392	71	0	12	0	83
2R	25257393	80	0	5	0	85
2R	25257394	51	0	32	0	83
2R	25257396	84	0	3	0	87
2R	25257397	69	0	17	0	86
2R	25257398	65	0	21	0	86
2R	25257404	33	0	54	0	87
2R	25257405	27	0	60	0	87
2R	25257406	50	0	39	0	89
2R	25257414	68	0	24	0	92
2R	25257417	44	0	46	0	90
2R	25257418	50	0	42	0	92
2R	25257420	79	0	15	0	94
2R	25257424	86	0	15	0	101
2R	25257425	30	0	70	0	100
2R	25257426	22	0	78	0	100
2R	25257427	79	0	24	0	103
2R	25257431	90	0	13	0	103
2R	25257439	93	0	14	0	107
2R	25257445	70	0	36	0	106
2R	25257451	51	0	56	0	107
2R	25257453	87	0	17	0	104
2R	25257483	86	0	24	0	110
2R	25257508	57	0	63	0	120
2R	25257625	62	0	7	0	69
2R	25257632	68	0	2	0	70
2R	25257633	66	0	2	0	68
2R	25257638	68	0	0	0	68
2R	25257643	42	0	23	1	66
2R	25257682	14	0	26	0	40
2R	25257683	20	0	16	0	36
2R	25257699	27	0	1	0	28
2R	25257701	21	0	9	0	30
2R	25257703	14	0	15	0	29
2R	25257714	25	0	10	0	35
2R	25257732	18	0	15	0	33
2R	25257735	13	0	23	0	36
2R	25257740	20	0	19	0	39
2R	25257741	32	0	8	0	40
2R	25257743	32	0	8	0	40
2R	25257781	38	0	9	0	47
2R	25257788	49	0	0	0	49
2R	25257789	44	0	1	0	45
2R	25257792	39	0	8	0	47
2R	25257806	17	0	19	0	36
2R	25257812	28	0	9	0	37
2R	25257820	29	0	10	0	39
2R	25257832	15	0	21	0	36
2R	25257836	19	0	20	0	39
2R	25257964	8	0	16	0	24
3L	71000	0	0	0	0	0
3L	214328	0	48	0	0	48
3L	226141	2453	0	98	0	2551
3L	271201	0	0	2	0	2
3L	336697	0	0	0	0	0
3L	346424	2	0	0	0	2
3L	346882	0	0	0	15	15
3L	411895	0	0	0	0	0
3L	462074	0	0	0	0	0
3L	498116	0	0	0	0	0
3L	546751	0	0	0	0	0
3L	575217	46	0	0	0	46
3L	598790	17	0	4	0	21
3L	991441	110	0	14	0	124
3L	1010857	0	0	1	0	1
3L	1011246	0	0	0	0	0
3L	1011285	0	0	0	0	0
3L	1026639	0	11	0	93	104
3L	1027109	0	47	0	91	138
3L	1033059	0	0	0	1	1
3L	1034384	0	0	0	2	2
3L	1034386	0	0	0	2	2
3L	1044064	1	0	0	0	1
3L	1046651	0	0	0	0	0
3L	1135014	0	0	0	0	0
3L	1138357	0	0	0	0	0
3L	1210848	0	0	0	0	0
3L	1217228	3	0	0	0	3
3L	1227904	0	0	0	0	0
3L	1230644	0	0	65	0	65
3L	1318745	0	0	0	0	0
3L	1407143	0	0	0	0	0
3L	1490348	0	0	0	3	3
3L	1526045	0	0	0	12	12
3L	1556299	0	0	0	237	237
3L	1689558	15	0	0	0	15
3L	1727806	0	0	0	0	0
3L	1782670	0	297	0	236	533
3L	1945203	0	0	0	7	7
3L	2001719	0	0	0	0	0
3L	2039782	0	5	0	78	83
3L	2039908	0	16	0	109	125
3L	2039918	0	29	0	97	126
3L	2039919	0	2	0	129	131
3L	2042849	0	0	0	125	125
3L	2043519	0	0	0	128	128
3L	2044551	0	0	0	98	98
3L	2044916	0	0	0	134	134
3L	2045959	0	0	0	110	110
3L	2051548	0	0	0	41	41
3L	2054348	0	0	0	4	4
3L	2055902	0	0	0	2	2
3L	2056964	0	0	0	2	2
3L	2060460	0	0	0	4	4
3L	2074107	0	0	0	12	12
3L	2080672	0	0	0	27	27
3L	2080891	0	0	0	25	25
3L	2089039	0	0	0	18	18
3L	2096769	0	0	0	69	69
3L	2125496	1	1	0	220	222
3L	2126093	0	9	0	217	226
3L	2134649	0	3	0	97	100
3L	2135049	0	0	0	91	91
3L	2190111	0	0	0	129	129
3L	2245947	0	0	0	0	0
3L	2251644	0	0	0	0	0
3L	2348350	0	0	0	0	0
3L	2372937	0	0	36	0	36
3L	2377732	0	0	0	0	0
3L	2390472	0	0	0	0	0
3L	2424958	0	0	0	0	0
3L	2440451	4	0	0	0	4
3L	2458238	24	0	0	0	24
3L	2469405	1	0	0	0	1
3L	2469912	0	0	0	0	0
3L	2473344	0	0	0	0	0
3L	2481805	2	0	0	0	2
3L	2498728	0	1	0	93	94
3L	2499964	0	0	0	1530	1530
3L	2519293	0	0	0	1	1
3L	2578670	0	0	0	0	0
3L	2657532	0	108	0	0	108
3L	2665990	0	27	0	54	81
3L	2666151	0	38	0	23	61
3L	2773256	0	0	0	71	71
3L	2773526	0	0	0	53	53
3L	2777176	0	0	59	0	59
3L	2778433	54	0	0	0	54
3L	2778439	0	0	53	0	53
3L	2784069	0	19	0	0	19
3L	2784359	0	0	20	0	20
3L	2785524	0	0	18	0	18
3L	2785531	0	0	0	20	20
3L	2785536	0	0	0	21	21
3L	2785542	0	19	0	0	19
3L	2785610	0	26	0	0	26
3L	2785621	0	0	0	27	27
3L	2785658	29	0	0	0	29
3L	2786034	0	0	0	0	0
3L	2791593	0	0	0	46	46
3L	2799685	0	1	0	0	1
3L	2882059	0	0	0	0	0
3L	2924789	188	1	11	0	200
3L	2924790	195	0	14	0	209
3L	2924829	142	0	72	0	214
3L	2925090	48	0	124	0	172
3L	2925255	20	1	138	1	160
3L	2925550	0	0	70	0	70
3L	2939953	73	0	55	0	128
3L	2940825	229	0	7	0	236
3L	2940919	176	0	43	0	219
3L	2941131	38	0	189	0	227
3L	2941132	13	0	212	0	225
3L	2941311	164	0	13	0	177
3L	2941312	7	0	172	0	179
3L	2941364	10	0	138	0	148
3L	2941396	29	0	94	0	123
3L	2941425	54	0	95	0	149
3L	2941426	4	1	142	0	147
3L	2961305	0	0	0	0	0
3L	3086223	162	0	40	0	202
3L	3114961	0	0	1	88	89
3L	3150180	0	0	0	0	0
3L	3226015	14	0	5	0	19
3L	3311439	0	0	0	0	0
3L	3359345	57	0	45	0	102
3L	3361215	0	124	0	0	124
3L	3371858	0	107	0	56	163
3L	3371901	0	86	1	77	164
3L	3371976	0	70	0	133	203
3L	3407053	0	0	0	0	0
3L	3442381	0	0	0	0	0
3L	3471786	0	0	0	102	102
3L	3555912	1	0	0	0	1
3L	3729820	0	0	0	0	0
3L	3761976	0	0	0	1	1
3L	3762337	0	0	0	0	0
3L	3781259	0	29	0	0	29
3L	3786975	0	0	0	0	0
3L	3815844	0	0	0	0	0
3L	3837134	123	0	0	0	123
3L	3892642	0	0	81	0	81
3L	3904309	5	0	0	0	5
3L	3988087	63	0	4	0	67
3L	4089220	0	0	0	0	0
3L	4092326	857	0	9	0	866
3L	4172458	0	0	44	0	44
3L	4198341	27	0	25	0	52
3L	4264563	0	0	0	0	0
3L	4307932	1	0	0	0	1
3L	4308806	0	0	0	0	0
3L	4314575	1	0	0	0	1
3L	4314576	0	0	1	0	1
3L	4314586	1	0	0	0	1
3L	4316475	0	0	0	0	0
3L	4317484	0	3	0	0	3
3L	4317522	0	0	0	0	0
3L	4317524	0	0	0	0	0
3L	4317564	0	0	3	0	3
3L	4318105	0	0	3	0	3
3L	4318481	0	0	0	0	0
3L	4369162	0	193	0	103	296
3L	4369184	0	192	0	83	275
3L	4369185	0	98	0	179	277
3L	4369207	0	20	0	319	339
3L	4369208	0	19	0	315	334
3L	4369213	0	27	0	303	330
3L	4369313	0	0	0	354	354
3L	4369422	0	79	0	206	285
3L	4369445	0	26	1	229	256
3L	4369455	0	18	0	267	285
3L	4369459	0	27	0	247	274
3L	4429963	18	0	267	0	285
3L	4429967	165	0	122	0	287
3L	4430199	104	0	30	0	134
3L	4430208	26	0	112	0	138
3L	4431761	30	0	191	0	221
3L	4432486	108	0	153	0	261
3L	4432487	51	0	214	1	266
3L	4433319	208	0	151	0	359
3L	4433320	37	0	319	0	356
3L	4446288	0	0	0	0	0
3L	4584256	12	0	83	0	95
3L	4585849	85	0	43	0	128
3L	4585851	104	0	23	0	127
3L	4585858	86	0	36	0	122
3L	4585859	24	0	96	0	120
3L	4585865	77	0	37	0	114
3L	4586039	71	0	2	0	73
3L	4586053	57	0	20	0	77
3L	4586714	432	0	68	0	500
3L	4586715	115	0	380	0	495
3L	4590437	206	0	48	0	254
3L	4590448	214	1	53	0	268
3L	4590461	262	0	17	0	279
3L	4590463	277	0	2	0	279
3L	4590484	268	0	23	0	291
3L	4590685	154	0	115	0	269
3L	4590708	193	0	82	0	275
3L	4590709	112	0	165	0	277
3L	4591116	115	0	134	0	249
3L	4591123	209	0	32	0	241
3L	4591132	209	0	35	0	244
3L	4591179	261	0	41	0	302
3L	4591222	296	0	44	0	340
3L	4591226	344	0	17	0	361
3L	4591259	286	0	26	0	312
3L	4591369	280	0	26	0	306
3L	4591744	275	0	12	0	287
3L	4732441	0	0	0	0	0
3L	4811851	0	0	1	0	1
3L	4822418	64	0	1	0	65
3L	4822420	64	0	0	0	64
3L	4867777	0	0	0	0	0
3L	4897294	0	2	0	0	2
3L	4985909	0	0	0	0	0
3L	4986257	0	0	0	0	0
3L	4986611	0	0	0	0	0
3L	4986891	0	0	0	0	0
3L	5045427	0	0	0	0	0
3L	5102529	0	0	0	0	0
3L	5116849	0	1	0	0	1
3L	5133159	0	0	11	0	11
3L	5133686	0	0	0	0	0
3L	5135062	91	0	0	0	91
3L	5135116	96	0	0	0	96
3L	5139737	53	0	0	0	53
3L	5144164	0	0	10	0	10
3L	5157874	0	3	0	120	123
3L	5160640	0	1	0	82	83
3L	5171594	0	0	0	0	0
3L	5171618	0	0	0	0	0
3L	5185014	0	1	0	1	2
3L	5188016	0	0	0	0	0
3L	5191766	0	0	0	2	2
3L	5192055	0	0	0	0	0
3L	5212866	3	0	0	0	3
3L	5212915	0	4	0	0	4
3L	5212920	0	4	0	0	4
3L	5213133	0	0	0	3	3
3L	5213134	3	0	0	0	3
3L	5247676	0	0	0	15	15
3L	5334897	0	0	0	0	0
3L	5347418	0	0	0	0	0
3L	5435357	0	0	0	0	0
3L	5664597	0	0	0	0	0
3L	5692734	1	0	0	0	1
3L	5696130	24	0	12	0	36
3L	5740525	23	0	33	0	56
3L	5743791	21	0	7	0	28
3L	5745060	23	0	7	0	30
3L	5746701	182	0	0	0	182
3L	5746708	180	0	12	0	192
3L	5746772	177	0	32	0	209
3L	5750034	0	0	0	2	2
3L	5764525	0	0	0	150	150
3L	5815976	0	0	3	0	3
3L	6008890	0	0	0	0	0
3L	6008957	0	0	0	0	0
3L	6009017	0	0	0	0	0
3L	6062381	0	0	0	0	0
3L	6193542	24	0	0	0	24
3L	6285897	0	0	0	0	0
3L	6331348	17	0	0	0	17
3L	6459287	0	0	0	0	0
3L	6506202	0	0	0	0	0
3L	6506212	0	0	0	0	0
3L	6534871	0	0	0	0	0
3L	6641116	0	0	0	0	0
3L	6643565	0	0	0	0	0
3L	6643648	0	0	0	0	0
3L	6643649	0	0	0	0	0
3L	6643749	0	0	0	0	0
3L	6643752	0	0	0	0	0
3L	6689091	0	0	0	0	0
3L	6689204	0	0	0	0	0
3L	6694843	0	0	0	1	1
3L	6734513	64	0	0	0	64
3L	6754914	0	49	0	0	49
3L	6769182	0	0	0	0	0
3L	6786307	0	0	1	0	1
3L	6800394	0	0	0	0	0
3L	6800402	0	0	0	0	0
3L	6949680	0	127	0	517	644
3L	6949683	0	31	0	620	651
3L	6949688	0	121	0	542	663
3L	6949690	1	174	0	494	669
3L	6950110	0	268	0	600	868
3L	6950168	1	162	0	989	1152
3L	6954754	0	694	0	844	1538
3L	7021467	0	0	0	0	0
3L	7059577	0	0	0	38	38
3L	7180438	0	39	0	44	83
3L	7218079	0	0	0	0	0
3L	7235679	0	0	0	0	0
3L	7236912	0	0	0	0	0
3L	7324105	0	0	0	27	27
3L	7326096	24	0	0	0	24
3L	7417841	0	0	0	0	0
3L	7650269	0	0	0	0	0
3L	7654672	0	15	0	47	62
3L	7665256	660	0	0	0	660
3L	7666636	0	16	0	36	52
3L	7694236	0	1	0	0	1
3L	7696248	0	0	0	4	4
3L	7830703	0	3	0	19	22
3L	7923214	0	0	0	0	0
3L	7928680	0	84	0	28	112
3L	7939905	0	0	0	0	0
3L	7960324	0	0	0	0	0
3L	7979842	0	0	0	0	0
3L	8041599	0	0	0	0	0
3L	8066395	0	0	0	0	0
3L	8120375	0	0	100	0	100
3L	8120519	0	0	100	0	100
3L	8121502	6	0	0	0	6
3L	8126738	0	0	48	0	48
3L	8126864	38	0	0	0	38
3L	8184846	0	0	46	0	46
3L	8185142	0	0	3	0	3
3L	8228580	0	0	0	0	0
3L	8375374	0	0	0	0	0
3L	8434395	0	0	0	94	94
3L	8444869	0	4	0	0	4
3L	8492631	0	0	0	0	0
3L	8532834	0	0	0	75	75
3L	8532845	0	78	0	0	78
3L	8588267	0	0	199	0	199
3L	8588835	5	0	0	0	5
3L	8589446	18	0	6	0	24
3L	8597507	331	2	1	0	334
3L	8648332	11994	0	2	4	12000
3L	8678627	0	0	86	0	86
3L	8678628	0	0	86	0	86
3L	8678673	105	0	0	0	105
3L	8719077	14	0	0	0	14
3L	8724069	11	0	0	0	11
3L	8736015	0	0	0	3	3
3L	8740095	0	19	0	346	365
3L	8759599	16	0	0	0	16
3L	8775212	0	0	2	0	2
3L	8786152	59	0	0	0	59
3L	8798415	43	0	0	0	43
3L	8827752	0	0	72	0	72
3L	8839904	0	0	0	0	0
3L	8844956	0	0	0	0	0
3L	8850667	0	0	0	0	0
3L	8885355	0	0	0	0	0
3L	8892723	2	0	0	0	2
3L	8913159	0	0	0	0	0
3L	8913856	1	0	0	0	1
3L	8913897	0	0	1	0	1
3L	8931961	19	0	0	0	19
3L	8940166	50	0	0	1	51
3L	8983591	0	457	0	0	457
3L	8985580	0	42	0	0	42
3L	8987752	1	0	0	132	133
3L	8991591	0	41	0	0	41
3L	8993217	0	44	0	0	44
3L	8997822	0	17	0	0	17
3L	9100899	0	2	0	15	17
3L	9124178	0	1	0	3	4
3L	9124180	0	0	0	3	3
3L	9124570	0	1	0	3	4
3L	9144950	312	0	1	0	313
3L	9146324	53	0	0	0	53
3L	9147825	0	2	0	29	31
3L	9149081	0	2	0	35	37
3L	9151835	0	10	0	75	85
3L	9151836	0	8	0	83	91
3L	9155185	0	28	0	66	94
3L	9155218	0	84	0	4	88
3L	9161860	0	0	0	7	7
3L	9161861	0	1	0	7	8
3L	9161863	0	2	0	8	10
3L	9161864	0	0	0	10	10
3L	9161865	0	0	0	10	10
3L	9162917	0	33	0	41	74
3L	9162924	0	9	0	53	62
3L	9172898	0	0	1	0	1
3L	9258715	7	0	0	0	7
3L	9263686	0	0	0	0	0
3L	9270392	0	0	50	0	50
3L	9282077	2	0	0	0	2
3L	9287571	0	0	0	31	31
3L	9341681	13	0	0	0	13
3L	9378596	0	0	0	55	55
3L	9488590	0	3	0	0	3
3L	9497783	0	0	0	6	6
3L	9562249	0	0	0	0	0
3L	9566820	0	0	0	0	0
3L	9566821	0	0	0	0	0
3L	9587305	11	0	0	0	11
3L	9608849	0	1	0	0	1
3L	9622044	33	0	0	0	33
3L	9625888	0	0	13	0	13
3L	9631909	0	0	0	48	48
3L	9632368	0	0	0	184	184
3L	9633307	0	0	0	196	196
3L	9644938	16	0	0	0	16
3L	9645414	0	0	0	34	34
3L	9648209	0	1	0	0	1
3L	9649368	0	0	0	0	0
3L	9666680	0	0	0	0	0
3L	9668976	0	43	1	37	81
3L	9682712	0	0	4	0	4
3L	9682988	0	0	0	0	0
3L	9686533	0	0	0	62	62
3L	9688751	0	0	0	45	45
3L	9709045	1	0	152	0	153
3L	9717933	0	0	0	1	1
3L	9724380	0	0	0	10	10
3L	9724514	0	9	0	0	9
3L	9724607	4	0	0	0	4
3L	9730982	1807	0	0	0	1807
3L	9734333	0	0	0	231	231
3L	9736382	0	0	0	18	18
3L	9736627	0	1	0	21	22
3L	9738180	0	389	0	0	389
3L	9740249	0	17	0	0	17
3L	9740401	0	20	0	0	20
3L	9774568	0	0	1	0	1
3L	9799424	3	0	0	0	3
3L	9807026	0	0	2	0	2
3L	9814841	0	1	0	0	1
3L	9815342	0	0	0	0	0
3L	9816197	0	0	0	0	0
3L	9816249	0	0	0	0	0
3L	9816250	0	0	0	0	0
3L	9816252	0	0	0	0	0
3L	9816265	33	0	0	0	33
3L	9816267	0	0	37	0	37
3L	9817489	0	0	0	0	0
3L	9819018	0	0	0	0	0
3L	9821256	0	0	0	0	0
3L	9821464	0	0	0	0	0
3L	9821472	0	0	0	0	0
3L	9821474	0	0	0	0	0
3L	9821481	0	0	0	0	0
3L	9821685	0	0	0	5	5
3L	9833291	278	0	39	0	317
3L	9833294	226	0	113	0	339
3L	9833300	171	0	179	0	350
3L	9833301	113	0	230	0	343
3L	9833364	302	0	17	0	319
3L	9833369	70	0	258	0	328
3L	9833370	311	0	27	0	338
3L	9833459	222	0	130	0	352
3L	9833484	302	0	61	1	364
3L	9833487	337	0	20	0	357
3L	9867222	107	0	17	0	124
3L	9867339	102	0	158	1	261
3L	9885244	0	0	0	17	17
3L	9885764	0	0	0	13	13
3L	9886836	0	0	0	13	13
3L	9892134	27	0	31	0	58
3L	9943795	0	0	0	0	0
3L	9943907	0	0	0	0	0
3L	9972754	4	0	0	0	4
3L	9974737	17	0	0	0	17
3L	10023375	0	0	0	0	0
3L	10153722	0	0	0	7	7
3L	10182898	0	1	0	1	2
3L	10182954	0	0	0	0	0
3L	10185757	0	0	0	4	4
3L	10197944	0	0	0	0	0
3L	10287759	0	0	0	0	0
3L	10358012	0	0	0	0	0
3L	10423429	0	0	0	1	1
3L	10478991	0	0	0	0	0
3L	10516387	5	0	2	0	7
3L	10556226	0	0	0	0	0
3L	10583448	0	15	0	0	15
3L	10644076	0	0	89	0	89
3L	10659046	0	0	0	0	0
3L	10672257	0	0	0	0	0
3L	10785536	0	0	0	0	0
3L	10787010	2	0	0	0	2
3L	10787012	2	0	0	0	2
3L	10820249	0	0	0	0	0
3L	10848012	0	0	0	0	0
3L	10944093	0	0	0	0	0
3L	11038040	0	6	0	161	167
3L	11067981	18	0	0	0	18
3L	11073860	0	0	0	120	120
3L	11166174	0	18	0	0	18
3L	11166793	18	0	0	0	18
3L	11166799	0	0	0	17	17
3L	11166802	0	0	0	18	18
3L	11166932	0	0	0	26	26
3L	11175776	2	0	0	0	2
3L	11175795	1	0	0	0	1
3L	11175891	3	0	0	0	3
3L	11175895	2	0	1	0	3
3L	11175896	1	0	1	0	2
3L	11176183	1	0	2	0	3
3L	11176185	1	0	2	0	3
3L	11178469	0	0	171	0	171
3L	11203066	0	0	0	32	32
3L	11209891	0	0	26	0	26
3L	11211185	41	0	0	0	41
3L	11211200	41	0	0	0	41
3L	11218031	0	0	0	0	0
3L	11218035	0	0	0	0	0
3L	11218227	0	0	0	0	0
3L	11225111	107	0	0	0	107
3L	11225150	81	0	49	0	130
3L	11280036	0	0	0	0	0
3L	11519814	0	15	0	0	15
3L	11552592	0	0	0	3	3
3L	11553320	0	0	0	1	1
3L	11553330	0	0	0	0	0
3L	11553333	0	0	0	0	0
3L	11559570	0	0	0	0	0
3L	11599583	1	0	0	0	1
3L	11650023	0	0	0	65	65
3L	11670833	0	0	0	3	3
3L	11734662	0	17	0	78	95
3L	11746631	0	0	0	0	0
3L	11764981	0	0	0	0	0
3L	11803246	0	0	0	0	0
3L	11807770	1	0	0	0	1
3L	11815790	0	29	0	0	29
3L	11824846	22	0	0	0	22
3L	11827577	0	0	0	3	3
3L	11837250	0	0	0	1	1
3L	11837265	0	1	0	0	1
3L	11857720	0	0	0	1	1
3L	11857797	0	0	0	0	0
3L	11857887	0	0	0	0	0
3L	11857906	0	0	0	0	0
3L	11956759	0	0	0	0	0
3L	11964188	0	2	0	0	2
3L	11974542	0	0	0	0	0
3L	12022418	0	0	0	0	0
3L	12023402	0	0	0	0	0
3L	12066158	0	0	0	0	0
3L	12070965	0	30	0	0	30
3L	12100697	0	0	0	0	0
3L	12105494	0	0	0	0	0
3L	12123225	0	1	1	491	493
3L	12211671	0	71	0	63	134
3L	12211756	0	21	0	77	98
3L	12212148	0	92	0	5	97
3L	12212309	0	109	0	10	119
3L	12239964	0	0	0	0	0
3L	12244780	0	0	0	0	0
3L	12252166	0	0	0	0	0
3L	12297495	0	0	0	0	0
3L	12423647	0	0	0	0	0
3L	12426521	0	0	0	0	0
3L	12430208	0	0	0	0	0
3L	12440786	0	0	0	0	0
3L	12445033	0	0	0	0	0
3L	12463065	0	0	0	0	0
3L	12463742	0	0	19	0	19
3L	12471180	0	0	0	0	0
3L	12471570	0	0	0	0	0
3L	12493418	0	0	3	0	3
3L	12494398	2	0	0	0	2
3L	12508254	0	0	0	0	0
3L	12508840	0	0	0	1	1
3L	12509140	0	0	0	1	1
3L	12510503	1	0	0	0	1
3L	12519462	153	0	0	0	153
3L	12519598	183	0	0	0	183
3L	12524172	1	0	0	0	1
3L	12527022	0	0	0	0	0
3L	12529862	0	0	0	1	1
3L	12546839	0	0	0	0	0
3L	12691864	0	0	0	0	0
3L	12731393	0	0	0	0	0
3L	12731797	0	0	0	0	0
3L	12768257	24	0	0	0	24
3L	12826688	0	14	0	0	14
3L	12853773	0	0	120	0	120
3L	12856591	89	0	0	0	89
3L	13007953	0	2	0	0	2
3L	13020448	0	27	0	107	134
3L	13038438	24	0	27	0	51
3L	13194742	0	0	0	0	0
3L	13194835	1	0	0	0	1
3L	13195237	0	0	0	0	0
3L	13195308	0	0	0	0	0
3L	13196156	0	0	0	0	0
3L	13196212	0	0	0	0	0
3L	13218792	0	0	0	0	0
3L	13225212	0	0	0	0	0
3L	13309717	0	0	0	0	0
3L	13312105	0	0	0	0	0
3L	13312111	0	0	0	0	0
3L	13418107	0	6	0	10	16
3L	13435185	0	6	0	16	22
3L	13467599	0	101	0	0	101
3L	13467636	0	110	0	0	110
3L	13467653	0	108	0	0	108
3L	13480590	0	0	58	0	58
3L	13492027	0	0	0	0	0
3L	13494294	1	0	0	0	1
3L	13494298	2	0	0	0	2
3L	13494304	2	0	0	0	2
3L	13494305	0	0	2	0	2
3L	13494355	0	0	0	2	2
3L	13494364	2	0	0	0	2
3L	13494365	0	0	2	0	2
3L	13494372	0	2	0	0	2
3L	13494373	0	2	0	0	2
3L	13494374	2	0	0	0	2
3L	13494390	0	0	2	0	2
3L	13494392	0	2	0	0	2
3L	13494408	0	1	0	0	1
3L	13494438	2	0	0	0	2
3L	13494439	0	2	0	0	2
3L	13494441	2	0	0	0	2
3L	13494445	2	0	0	0	2
3L	13494448	2	0	0	0	2
3L	13494451	3	0	0	0	3
3L	13494457	1	0	2	0	3
3L	13494472	0	0	0	3	3
3L	13494497	4	0	0	0	4
3L	13494498	2	0	0	0	2
3L	13494519	0	4	0	0	4
3L	13494520	0	0	0	2	2
3L	13494596	0	0	3	0	3
3L	13494693	3	0	0	0	3
3L	13494842	0	0	24	0	24
3L	13502410	0	0	0	5	5
3L	13535416	0	0	17	1	18
3L	13600286	0	0	0	0	0
3L	13703883	0	0	0	0	0
3L	13858574	107	0	0	0	107
3L	13859907	0	0	38	0	38
3L	13869566	59	0	0	0	59
3L	13871006	0	0	0	17	17
3L	13888962	0	0	0	7	7
3L	13901738	0	0	0	87	87
3L	13912261	0	3	0	0	3
3L	13919434	0	0	0	23	23
3L	13927002	0	0	0	14	14
3L	13929952	26	0	12	0	38
3L	13933146	75	0	0	0	75
3L	13933176	78	0	0	0	78
3L	13959984	35	0	0	0	35
3L	13962782	0	0	0	4	4
3L	13967324	1	0	0	0	1
3L	13974178	61	0	0	0	61
3L	14000997	0	0	0	26	26
3L	14001118	0	0	0	30	30
3L	14063120	0	0	0	0	0
3L	14066713	69	0	0	0	69
3L	14070532	0	0	0	0	0
3L	14071510	0	0	0	8	8
3L	14084672	0	0	0	0	0
3L	14084674	0	0	0	0	0
3L	14090360	0	0	0	0	0
3L	14090416	0	0	0	0	0
3L	14090417	0	0	0	0	0
3L	14096104	0	0	0	0	0
3L	14096107	0	0	0	0	0
3L	14096112	0	0	0	0	0
3L	14096121	0	0	0	0	0
3L	14096133	0	0	0	0	0
3L	14096136	0	0	0	0	0
3L	14096146	0	0	0	0	0
3L	14097465	0	0	0	0	0
3L	14097466	0	0	0	0	0
3L	14097468	0	0	0	0	0
3L	14097688	0	0	0	0	0
3L	14097689	0	0	0	0	0
3L	14097845	0	0	0	0	0
3L	14097870	0	0	0	0	0
3L	14097874	0	0	0	0	0
3L	14098080	0	0	0	0	0
3L	14098096	0	0	0	0	0
3L	14098097	0	0	0	0	0
3L	14098360	0	0	0	0	0
3L	14098377	0	0	0	0	0
3L	14098378	0	0	0	0	0
3L	14098379	0	0	0	0	0
3L	14100722	0	0	0	0	0
3L	14100724	0	0	0	0	0
3L	14111714	0	0	0	0	0
3L	14112636	0	12	0	0	12
3L	14212209	0	0	64	0	64
3L	14227988	1	0	0	0	1
3L	14235297	0	0	0	0	0
3L	14236740	1	0	0	0	1
3L	14368016	18	0	0	0	18
3L	14426456	0	0	0	0	0
3L	14439493	0	0	0	0	0
3L	14755055	0	0	0	0	0
3L	14764947	67	0	0	0	67
3L	14799253	37	0	4	0	41
3L	14862538	0	0	0	0	0
3L	14882352	0	0	0	0	0
3L	15043222	0	1	0	0	1
3L	15102878	0	0	0	0	0
3L	15102879	0	0	0	0	0
3L	15102886	0	0	0	0	0
3L	15102895	0	0	0	0	0
3L	15102896	0	0	0	0	0
3L	15102897	0	0	0	0	0
3L	15102934	0	0	0	1	1
3L	15102939	1	0	0	0	1
3L	15472441	0	0	0	0	0
3L	15517405	0	0	0	0	0
3L	15532890	0	0	0	0	0
3L	15555171	6	0	0	0	6
3L	15658259	0	0	0	0	0
3L	15658274	0	0	0	0	0
3L	15659522	0	0	0	0	0
3L	15757800	0	0	0	0	0
3L	15893762	0	0	0	21	21
3L	15895755	0	0	0	0	0
3L	16052231	0	0	1	0	1
3L	16111589	0	31	0	87	118
3L	16181016	0	0	0	0	0
3L	16181038	0	0	0	0	0
3L	16181052	0	0	0	0	0
3L	16181053	0	0	0	0	0
3L	16181094	0	0	0	0	0
3L	16182056	0	0	0	0	0
3L	16182169	0	0	0	0	0
3L	16182170	0	0	0	0	0
3L	16186140	0	0	0	0	0
3L	16186145	0	0	0	0	0
3L	16186363	0	0	0	0	0
3L	16254434	0	0	0	0	0
3L	16254435	0	0	0	0	0
3L	16255064	0	0	0	0	0
3L	16255072	0	0	0	0	0
3L	16262552	0	0	0	0	0
3L	16270810	0	0	0	0	0
3L	16291947	0	0	0	0	0
3L	16577155	0	0	0	2	2
3L	16616020	17	0	0	0	17
3L	16616021	0	0	0	15	15
3L	16617760	0	0	0	0	0
3L	16642757	0	0	0	0	0
3L	16645041	0	0	0	0	0
3L	16674672	0	0	0	0	0
3L	16678530	0	115	0	0	115
3L	16686521	0	0	0	0	0
3L	16688610	0	0	1	0	1
3L	16692734	1	0	0	0	1
3L	16728214	0	0	0	0	0
3L	16731471	0	0	0	0	0
3L	16736878	0	2	0	0	2
3L	16758529	0	0	1	0	1
3L	16786895	166	0	0	0	166
3L	16786980	0	0	0	0	0
3L	16908885	0	0	3	0	3
3L	16910270	0	0	4	0	4
3L	16968101	0	0	0	425	425
3L	17075627	0	2	0	5	7
3L	17378242	0	0	0	0	0
3L	17389187	0	0	0	0	0
3L	17425746	0	0	9	0	9
3L	17451133	14	0	0	0	14
3L	17475161	5	0	0	0	5
3L	17597746	0	25	0	0	25
3L	17668401	0	0	0	15	15
3L	17689993	0	0	0	1	1
3L	17726464	0	0	0	0	0
3L	17742206	0	0	0	3	3
3L	17951569	105	0	0	0	105
3L	17979662	0	0	0	1	1
3L	17979744	0	0	0	2	2
3L	18027635	0	0	0	0	0
3L	18087658	0	0	0	0	0
3L	18090225	0	0	0	0	0
3L	18132571	0	0	0	0	0
3L	18181206	0	0	0	0	0
3L	18189120	0	0	0	0	0
3L	18281392	0	0	0	0	0
3L	18281522	0	0	0	0	0
3L	18555038	0	0	0	0	0
3L	18596316	0	0	0	0	0
3L	18670895	0	0	0	92	92
3L	18682575	15	0	0	0	15
3L	18685220	0	0	0	64	64
3L	18685424	0	0	0	54	54
3L	18728861	0	0	0	0	0
3L	18800841	22	0	0	0	22
3L	18819562	0	0	0	8	8
3L	18878588	0	0	0	190	190
3L	18878936	0	0	0	420	420
3L	18897569	0	0	0	8	8
3L	18922609	0	9	0	0	9
3L	18922733	0	13	0	0	13
3L	19052915	0	0	0	0	0
3L	19055200	0	0	0	0	0
3L	19066432	0	0	0	27	27
3L	19067899	0	0	0	28	28
3L	19070611	0	1	0	0	1
3L	19106047	0	1	0	12	13
3L	19110288	0	51	0	0	51
3L	19147008	0	0	0	1	1
3L	19160049	0	0	0	0	0
3L	19283200	0	8	0	147	155
3L	19283264	0	65	0	96	161
3L	19283265	0	8	0	150	158
3L	19341568	0	0	0	37	37
3L	19369627	0	0	0	0	0
3L	19371398	0	0	0	0	0
3L	19399656	0	0	0	1	1
3L	19411978	0	0	0	0	0
3L	19501470	0	0	0	0	0
3L	19513044	0	0	0	0	0
3L	19516477	0	0	0	0	0
3L	19531391	0	0	1	0	1
3L	19542365	0	0	0	85	85
3L	19545728	0	0	9	0	9
3L	19578009	0	0	0	0	0
3L	19618855	0	0	0	1	1
3L	19689767	1241	0	191	0	1432
3L	19689870	122	0	723	0	845
3L	19689871	22	0	817	0	839
3L	19932956	0	0	0	0	0
3L	20035022	0	0	0	0	0
3L	20098494	0	0	0	116	116
3L	20156776	0	4	0	6	10
3L	20156958	0	11	0	26	37
3L	20252103	3	0	5	0	8
3L	20353020	0	0	0	29	29
3L	20379678	62	0	26	0	88
3L	20391933	0	0	0	13	13
3L	20420837	0	0	0	0	0
3L	20427294	0	0	0	23	23
3L	20428234	0	0	0	26	26
3L	20453518	0	0	0	0	0
3L	20465542	0	0	0	0	0
3L	20502571	1	0	0	0	1
3L	20502628	0	0	0	0	0
3L	20503418	3	0	1	0	4
3L	20523500	0	43	0	63	106
3L	20598406	0	12	0	0	12
3L	20598874	0	0	0	23	23
3L	20690411	0	0	0	0	0
3L	20768391	0	14	0	0	14
3L	20773150	58	0	164	0	222
3L	20773190	64	0	137	0	201
3L	20773546	196	0	9	0	205
3L	20773569	167	0	59	0	226
3L	20773589	183	0	31	0	214
3L	20773609	174	0	41	0	215
3L	20773610	163	0	65	0	228
3L	20802315	1	0	0	0	1
3L	20817830	0	0	0	4	4
3L	20820474	0	0	49	0	49
3L	20867520	0	0	0	0	0
3L	20879740	0	0	0	0	0
3L	20885034	0	126	0	1	127
3L	20942629	0	1	0	0	1
3L	20975576	0	0	0	0	0
3L	21072555	176	0	0	0	176
3L	21115651	0	0	0	0	0
3L	21118999	0	0	0	0	0
3L	21130550	0	0	0	0	0
3L	21130556	0	0	0	0	0
3L	21130559	0	0	0	0	0
3L	21130564	0	0	0	0	0
3L	21130610	0	0	0	0	0
3L	21130611	0	0	0	0	0
3L	21130618	0	0	0	0	0
3L	21130621	0	0	0	0	0
3L	21164936	0	0	0	0	0
3L	21179937	0	82	0	0	82
3L	21195648	0	0	0	2	2
3L	21203253	54	0	4	0	58
3L	21204995	5	0	0	0	5
3L	21205002	6	0	0	0	6
3L	21207897	54	0	8	0	62
3L	21210325	70	0	0	0	70
3L	21213292	48	0	52	0	100
3L	21226173	0	0	0	0	0
3L	21309631	0	0	0	0	0
3L	21333937	15	0	51	0	66
3L	21390253	0	0	0	0	0
3L	21390256	0	0	0	0	0
3L	21390260	0	0	0	0	0
3L	21390271	0	0	0	0	0
3L	21390275	0	0	0	0	0
3L	21390282	0	0	0	0	0
3L	21390294	0	0	0	0	0
3L	21390295	0	0	0	0	0
3L	21390303	0	0	0	0	0
3L	21390314	0	0	0	0	0
3L	21391007	0	0	0	0	0
3L	21391234	0	0	0	0	0
3L	21391240	0	0	0	0	0
3L	21644394	0	0	0	0	0
3L	21644396	0	0	0	0	0
3L	21644402	0	0	0	0	0
3L	21696292	0	0	0	0	0
3L	21696294	0	0	0	0	0
3L	21696345	0	0	0	0	0
3L	21696349	0	0	0	0	0
3L	21696352	0	0	0	0	0
3L	21696354	0	0	0	0	0
3L	21696356	0	0	0	0	0
3L	21696357	0	0	0	0	0
3L	21696361	0	0	0	0	0
3L	21696364	0	0	0	0	0
3L	21696375	0	0	0	0	0
3L	21696397	0	0	0	0	0
3L	21696400	0	0	0	0	0
3L	21696404	0	0	0	0	0
3L	21696405	0	0	0	0	0
3L	21696410	0	0	0	0	0
3L	21714311	0	0	0	0	0
3L	21715425	0	0	0	0	0
3L	21717050	0	0	0	0	0
3L	21728957	7	0	0	0	7
3L	21845812	0	0	0	0	0
3L	22132252	0	0	0	0	0
3L	22133068	0	0	0	0	0
3L	22133070	0	0	0	0	0
3L	22169386	0	0	0	0	0
3L	22268084	6	0	7	0	13
3L	22273143	452	0	38	0	490
3L	22273144	486	0	9	0	495
3L	22463672	0	0	0	0	0
3L	22655901	0	0	0	0	0
3L	22731262	2	0	0	0	2
3L	22793765	0	0	0	11	11
3L	22826560	1	0	0	0	1
3L	22827988	1	0	0	0	1
3L	22894950	0	0	0	0	0
3L	22894959	0	0	0	0	0
3L	23022502	23	0	2	0	25
3L	23022517	17	0	7	0	24
3L	23022531	20	0	3	0	23
3L	23022558	15	0	6	0	21
3L	23022565	14	0	8	0	22
3L	23022570	8	0	16	0	24
3L	23022589	7	0	15	0	22
3L	23022624	10	0	8	0	18
3L	23022651	19	0	5	0	24
3L	23022665	21	0	2	0	23
3L	23022696	18	0	5	0	23
3L	23022733	11	0	8	0	19
3L	23022747	10	0	6	0	16
3L	23022860	20	0	0	0	20
3L	23022915	23	0	0	0	23
3L	23023572	19	0	4	0	23
3L	23023737	11	0	4	0	15
3L	23023745	13	0	2	0	15
3L	23023746	15	0	0	0	15
3L	23023752	5	0	6	0	11
3L	23023759	8	0	3	0	11
3L	23023768	4	0	6	0	10
3L	23023772	3	0	7	0	10
3L	23023773	8	0	2	0	10
3L	23023776	6	0	4	0	10
3L	23023778	6	0	4	0	10
3L	23034648	29	0	41	0	70
3L	23035386	69	0	9	0	78
3L	23035498	55	0	5	0	60
3L	23035510	30	0	30	1	61
3L	23036047	68	0	6	0	74
3L	23036053	31	0	44	0	75
3L	23036055	67	0	8	0	75
3L	23036058	2	0	74	0	76
3L	23036059	48	0	31	0	79
3L	23036066	19	0	60	0	79
3L	23036068	50	0	32	0	82
3L	23036071	3	0	82	0	85
3L	23036082	76	0	6	0	82
3L	23036083	77	0	2	0	79
3L	23036084	78	0	6	0	84
3L	23036087	76	0	9	0	85
3L	23036098	76	0	16	0	92
3L	23036101	81	0	11	0	92
3L	23036116	63	0	39	0	102
3L	23036121	79	0	26	0	105
3L	23036453	64	0	10	0	74
3L	23036548	25	0	43	0	68
3L	23036588	39	0	32	0	71
3L	23036631	45	0	37	0	82
3L	23216253	0	0	0	0	0
3L	23228909	1	0	0	0	1
3L	23228910	1	0	0	0	1
3L	23228912	1	0	0	0	1
3L	23228932	0	0	1	0	1
3L	23231321	0	0	1	0	1
3L	23232223	0	0	1	0	1
3L	23241819	1	0	0	0	1
3L	23252714	0	0	0	0	0
3L	23284872	42	0	5	0	47
3L	23286473	113	0	13	0	126
3L	23286550	127	0	24	0	151
3L	23579149	0	0	0	0	0
3L	23742459	9	0	13	0	22
3L	23743265	15	0	2	0	17
3L	23743306	12	0	0	0	12
3L	23796662	0	0	0	0	0
3L	24031604	29	0	14	0	43
3L	24031889	16	0	11	0	27
3L	24031891	15	0	10	0	25
3L	24040526	0	0	0	0	0
3L	24074572	0	0	1	0	1
3L	24074586	0	0	1	0	1
3L	24074603	0	0	1	0	1
3L	24074606	1	0	0	0	1
3L	24074610	0	0	1	0	1
3L	24074617	1	0	0	0	1
3L	24074621	1	0	0	0	1
3L	24074625	1	0	0	0	1
3L	24074665	0	0	1	0	1
3L	24074669	0	0	1	0	1
3L	24074673	0	0	1	0	1
3L	24074677	0	0	1	0	1
3L	24074679	1	0	0	0	1
3L	24074680	0	0	1	0	1
3L	24074682	0	0	1	0	1
3L	24074685	1	0	0	0	1
3L	24074697	0	0	1	0	1
3L	24074700	0	0	1	0	1
3L	24074710	0	0	1	0	1
3L	24074713	0	0	1	0	1
3L	24074747	0	0	0	0	0
3L	24074754	0	0	0	0	0
3L	24074759	0	0	0	0	0
3L	24074986	0	0	1	0	1
3L	24184343	1	0	0	0	1
3L	24184352	1	0	0	0	1
3L	24260884	0	0	0	0	0
3L	24539756	8	0	5	0	13
3L	24574446	0	0	0	0	0
3L	24727794	0	0	0	0	0
3L	24729192	0	0	0	0	0
3L	24729203	0	0	0	0	0
3L	24729209	0	0	0	0	0
3L	24729558	1	0	0	0	1
3L	24734394	1	0	0	0	1
3L	24734409	1	0	0	0	1
3L	24734433	0	0	0	0	0
3L	24734434	0	0	0	0	0
3L	24734444	0	0	0	0	0
3L	24734445	0	0	0	0	0
3L	24734544	0	0	0	0	0
3L	24734545	0	0	0	0	0
3L	24734548	0	0	0	0	0
3L	24734549	0	0	0	0	0
3L	24734550	0	0	0	0	0
3L	24734565	0	0	0	0	0
3L	24734583	0	0	0	0	0
3L	24739737	0	0	0	0	0
3L	24739770	0	0	0	0	0
3L	24739940	0	0	0	0	0
3L	24739953	0	0	0	0	0
3L	25191188	0	0	0	0	0
3L	25404612	0	0	0	0	0
3L	25411101	0	0	0	0	0
3L	25440130	0	0	0	0	0
3L	25487370	0	0	0	0	0
3L	25519478	0	0	0	0	0
3L	25519484	0	0	0	0	0
3L	25519485	0	0	0	0	0
3L	25519514	0	0	0	0	0
3L	25519515	0	0	0	0	0
3L	25519516	0	0	0	0	0
3L	25519519	0	0	0	0	0
3L	25519523	0	0	0	0	0
3L	25519524	0	0	0	0	0
3L	25598311	0	0	0	0	0
3L	25608424	0	1	0	1	2
3L	25608425	0	2	0	0	2
3L	25608436	0	1	0	1	2
3L	25633906	0	0	0	42	42
3L	25633926	0	0	0	39	39
3L	25668383	0	3	0	3	6
3L	25668389	0	5	0	1	6
3L	25668390	0	1	0	5	6
3L	25668438	0	0	0	6	6
3L	25668442	0	4	0	2	6
3L	25668450	0	4	0	0	4
3L	25668451	0	4	0	1	5
3L	25668452	0	1	0	4	5
3L	25668462	0	2	0	0	2
3L	25668464	0	1	0	1	2
3L	25668466	0	1	0	1	2
3L	25668467	0	0	0	2	2
3L	25668501	0	0	0	2	2
3L	25668503	0	1	0	0	1
3L	25668653	0	1	0	1	2
3L	25669834	0	0	0	1	1
3L	25669886	0	0	0	1	1
3L	25669903	0	0	0	1	1
3L	25669904	0	0	0	1	1
3L	25669929	0	0	0	0	0
3L	25669935	0	0	0	0	0
3L	25674685	0	0	0	0	0
3L	25674703	0	0	0	0	0
3L	25674878	1	0	0	0	1
3L	25849333	0	0	0	0	0
3L	25873801	0	0	0	1	1
3L	25920861	0	0	0	0	0
3L	26001042	0	3	0	4	7
3L	26002127	0	0	0	8	8
3L	26002138	0	0	0	8	8
3L	26002140	0	0	0	8	8
3L	26002728	0	2	0	15	17
3L	26003264	0	1	0	10	11
3L	26009778	0	2	0	4	6
3L	26009830	0	3	0	4	7
3L	26012760	0	0	0	1	1
3L	26012768	0	0	0	1	1
3L	26582674	0	0	0	0	0
3L	26594673	0	0	0	0	0
3L	26610401	0	0	0	0	0
3L	26666453	0	0	0	0	0
3L	26667951	0	0	0	0	0
3L	26756592	0	0	0	0	0
3L	27281127	0	0	0	0	0
3L	27281185	0	0	0	0	0
3L	27845559	0	0	0	0	0
3L	27845560	0	0	0	0	0
3L	27845708	0	0	0	0	0
3L	28002470	0	0	0	1	1
3L	28002543	0	0	0	1	1
3L	28002555	0	0	0	1	1
3L	28002560	0	0	0	0	0
3L	28002748	0	0	0	0	0
3L	28002752	0	0	0	0	0
3R	2156963	0	0	0	0	0
3R	3122736	0	0	0	0	0
3R	3122737	0	0	0	0	0
3R	3751950	1	0	3	0	4
3R	4131662	2	0	2	0	4
3R	4185912	21	0	5	0	26
3R	4185926	20	0	6	0	26
3R	4185927	19	0	6	0	25
3R	4185928	24	0	2	0	26
3R	4186013	26	0	2	0	28
3R	4186020	27	0	0	0	27
3R	4186021	24	0	3	0	27
3R	4186029	26	0	0	0	26
3R	4186038	23	0	3	0	26
3R	4186053	23	0	5	0	28
3R	4186057	26	0	4	0	30
3R	4186060	23	0	4	0	27
3R	4186071	21	0	3	0	24
3R	4186077	27	0	0	0	27
3R	4186090	22	0	1	0	23
3R	4186091	14	0	9	0	23
3R	4279033	0	21	0	13	34
3R	4279036	1	23	0	11	35
3R	4279126	0	22	0	10	32
3R	4279127	0	24	0	7	31
3R	4279128	0	17	0	12	29
3R	4297057	85	0	20	0	105
3R	4297067	101	0	7	0	108
3R	4297086	108	0	2	0	110
3R	4297093	107	0	6	0	113
3R	4297095	109	0	5	0	114
3R	4297504	902	0	622	0	1524
3R	4297517	1177	0	285	0	1462
3R	4297518	1018	0	452	0	1470
3R	4299218	231	0	36	0	267
3R	4299387	193	0	40	0	233
3R	4299391	151	2	70	0	223
3R	4301117	120	0	18	0	138
3R	4301124	129	0	7	0	136
3R	4301140	100	0	20	0	120
3R	4301142	95	0	22	0	117
3R	4301144	116	0	4	0	120
3R	4301150	68	0	54	0	122
3R	4301158	109	0	22	0	131
3R	4301166	132	0	12	0	144
3R	4301174	139	0	11	0	150
3R	4301182	145	0	21	0	166
3R	4301190	129	0	32	0	161
3R	4301192	132	0	24	0	156
3R	4301196	147	0	16	1	164
3R	4301198	123	0	43	0	166
3R	4301200	128	1	40	0	169
3R	4301206	129	0	30	0	159
3R	4301208	135	0	29	0	164
3R	4301212	123	0	39	0	162
3R	4301214	146	0	23	0	169
3R	4301216	155	0	14	0	169
3R	4301240	133	0	24	0	157
3R	4301244	116	0	34	0	150
3R	4301246	108	0	42	1	151
3R	4301248	141	0	14	0	155
3R	4301250	139	0	15	0	154
3R	4301252	157	0	15	0	172
3R	4301254	174	0	26	0	200
3R	4301258	163	0	45	0	208
3R	4365384	137	0	123	0	260
3R	4365385	15	0	242	0	257
3R	4365474	125	0	148	0	273
3R	4493894	0	1	0	17	18
3R	4656505	43	0	29	0	72
3R	4702574	24	0	16	0	40
3R	4944773	3	0	0	0	3
3R	4965472	88	0	0	0	88
3R	5084900	0	0	0	122	122
3R	5236209	0	0	0	376	376
3R	5236328	0	0	0	0	0
3R	5236329	0	0	0	0	0
3R	5236332	0	0	0	0	0
3R	5236375	0	0	0	621	621
3R	5236378	0	0	0	638	638
3R	5260897	0	0	0	0	0
3R	5260900	0	0	0	0	0
3R	5260901	0	0	0	0	0
3R	5260908	0	0	0	0	0
3R	5260909	0	0	0	0	0
3R	5260910	0	0	0	0	0
3R	5260911	0	0	0	0	0
3R	5260913	0	0	0	0	0
3R	5260914	0	0	0	0	0
3R	5260918	0	0	0	0	0
3R	5260923	0	0	0	0	0
3R	5260926	0	0	0	0	0
3R	5260929	0	0	0	0	0
3R	5260930	0	0	0	0	0
3R	5260931	0	0	0	0	0
3R	5260932	0	0	0	0	0
3R	5260940	0	0	0	0	0
3R	5260941	0	0	0	0	0
3R	5260944	0	0	0	0	0
3R	5260945	0	0	0	0	0
3R	5260946	0	0	0	0	0
3R	5260947	0	0	0	0	0
3R	5260948	0	0	0	0	0
3R	5260949	0	0	0	0	0
3R	5260954	0	0	0	0	0
3R	5260956	0	0	0	0	0
3R	5260957	0	0	0	0	0
3R	5260958	0	0	0	0	0
3R	5260960	0	0	0	0	0
3R	5260961	0	0	0	0	0
3R	5260962	0	0	0	0	0
3R	5260963	0	0	0	0	0
3R	5260964	0	0	0	0	0
3R	5260965	0	0	0	0	0
3R	5260968	0	0	0	0	0
3R	5260969	0	0	0	0	0
3R	5260970	0	0	0	0	0
3R	5260971	0	0	0	0	0
3R	5260972	0	0	0	0	0
3R	5260973	0	0	0	0	0
3R	5260974	0	0	0	0	0
3R	5260976	0	0	0	0	0
3R	5260981	0	0	0	0	0
3R	5260982	0	0	0	0	0
3R	5260984	0	0	0	0	0
3R	5260985	0	0	0	0	0
3R	5260986	0	0	0	0	0
3R	5260987	0	0	0	0	0
3R	5260992	0	0	0	0	0
3R	5260993	0	0	0	0	0
3R	5260994	0	0	0	0	0
3R	5260995	0	0	0	0	0
3R	5260998	0	0	0	0	0
3R	5261005	0	0	0	0	0
3R	5261038	0	0	0	0	0
3R	5261039	0	0	0	0	0
3R	5261045	0	0	0	0	0
3R	5261046	0	0	0	0	0
3R	5261050	0	0	0	0	0
3R	5261052	0	0	0	0	0
3R	5261064	0	0	0	0	0
3R	5261070	0	0	0	0	0
3R	5261071	0	0	0	0	0
3R	5261073	0	0	0	0	0
3R	5268529	12	0	15	0	27
3R	5331180	0	1	0	2	3
3R	5456078	26	0	54	0	80
3R	5510248	0	14	0	71	85
3R	5512061	1	37	0	42	80
3R	5512062	0	28	0	56	84
3R	5579358	17	0	0	0	17
3R	5650231	65	0	84	0	149
3R	5650351	96	0	83	0	179
3R	5686487	9	0	1	0	10
3R	5794759	27	0	0	0	27
3R	5813914	0	0	0	15	15
3R	5835138	15	0	0	0	15
3R	6004380	1	243	1	439	684
3R	6198321	0	0	0	0	0
3R	6410404	0	0	0	0	0
3R	6454240	0	27	0	0	27
3R	6455990	0	20	0	27	47
3R	6456079	0	47	0	0	47
3R	6481790	0	0	0	4	4
3R	6482470	0	0	0	0	0
3R	6483189	0	0	1	0	1
3R	6646984	0	0	29	2	31
3R	6656412	0	0	0	48	48
3R	6825353	0	10	0	14	24
3R	7192775	50	0	278	0	328
3R	7192825	275	3	52	0	330
3R	7472957	0	0	0	12	12
3R	7474763	0	28	0	39	67
3R	7523172	0	0	0	1	1
3R	7527658	0	0	0	0	0
3R	7541970	1	0	0	0	1
3R	7541971	1	0	0	0	1
3R	7578932	0	1	0	0	1
3R	7632065	0	0	0	0	0
3R	7633948	0	0	0	1	1
3R	7857376	0	0	0	1	1
3R	7860890	0	3	0	34	37
3R	7886440	0	3	0	29	32
3R	7959962	0	0	0	1	1
3R	7975631	0	0	0	344	344
3R	8023269	0	48	0	115	163
3R	8025032	0	166	0	0	166
3R	8237633	0	0	0	32	32
3R	8380051	0	3	0	17	20
3R	8380439	0	25	0	10	35
3R	8380442	0	13	0	23	36
3R	8385971	0	30	0	0	30
3R	8386738	0	5	0	33	38
3R	8386758	0	6	0	31	37
3R	8658956	0	0	0	1	1
3R	8659112	0	0	0	2	2
3R	8661419	0	0	0	129	129
3R	8678362	0	0	21	0	21
3R	8736376	0	7	0	26	33
3R	8737810	0	16	0	21	37
3R	8775615	0	0	0	674	674
3R	8788015	0	0	0	0	0
3R	8788344	0	0	0	0	0
3R	8791608	0	0	0	0	0
3R	8795508	0	0	0	0	0
3R	8812828	0	0	0	4	4
3R	8834533	0	0	0	218	218
3R	8836915	0	78	0	36	114
3R	8836926	0	71	0	39	110
3R	8836929	0	64	0	46	110
3R	8837184	0	102	0	39	141
3R	8837191	0	100	0	46	146
3R	8837610	0	74	0	38	112
3R	8851870	0	0	0	2	2
3R	8864798	0	78	0	0	78
3R	8864972	0	0	0	63	63
3R	8867172	0	0	0	0	0
3R	8922284	0	0	0	0	0
3R	8937081	0	0	0	0	0
3R	8952096	0	1	0	0	1
3R	8992964	2	0	0	0	2
3R	9092757	0	0	0	2	2
3R	9094689	0	0	0	2	2
3R	9120444	0	0	0	13	13
3R	9134740	0	0	0	2	2
3R	9147309	0	0	0	3	3
3R	9192083	0	0	0	3	3
3R	9192878	0	0	0	4	4
3R	9195940	0	0	0	0	0
3R	9350774	1	0	0	0	1
3R	9354339	0	0	0	0	0
3R	9385249	0	0	0	2	2
3R	9394121	0	5	0	1	6
3R	9418495	9	0	2	0	11
3R	9418834	7	0	2	0	9
3R	9419410	9	0	2	0	11
3R	9419457	8	0	3	0	11
3R	9421085	0	0	0	0	0
3R	9428183	2	0	0	0	2
3R	9428227	3	0	1	0	4
3R	9428853	5	0	7	0	12
3R	9430861	6	0	6	0	12
3R	9430877	7	0	4	0	11
3R	9448522	227	0	42	1	270
3R	9451570	165	0	0	0	165
3R	9451939	158	1	63	0	222
3R	9455622	0	0	0	13	13
3R	9465643	0	0	0	58	58
3R	9492559	0	0	0	3	3
3R	9525980	0	0	96	0	96
3R	9544703	0	0	0	15	15
3R	9544820	0	1	0	6	7
3R	9591515	53	0	0	0	53
3R	9591859	29	0	0	0	29
3R	9614889	2	0	0	0	2
3R	9666847	0	0	0	0	0
3R	9721112	0	83	0	0	83
3R	9727213	0	55	0	0	55
3R	9729053	0	0	0	109	109
3R	9754511	0	0	1	16	17
3R	9761125	60	0	0	0	60
3R	9769425	125	0	54	0	179
3R	9798395	0	123	0	0	123
3R	9965066	1	0	0	0	1
3R	10029831	0	0	0	0	0
3R	10083460	2	0	0	0	2
3R	10097183	5	0	0	0	5
3R	10194903	40	0	15	0	55
3R	10194972	36	0	17	0	53
3R	10194990	33	0	19	0	52
3R	10195423	282	0	44	0	326
3R	10195426	15	0	305	0	320
3R	10195571	60	0	0	0	60
3R	10195983	204	0	105	0	309
3R	10195984	156	0	156	1	313
3R	10227022	8	0	5	0	13
3R	10228870	95	0	0	0	95
3R	10245424	114	0	21	0	135
3R	10245425	38	0	93	0	131
3R	10305770	45	0	0	0	45
3R	10333913	12	0	0	0	12
3R	10372369	0	0	0	22	22
3R	10391255	9	0	0	0	9
3R	10392923	10	0	0	0	10
3R	10393067	16	0	0	0	16
3R	10394318	14	0	0	0	14
3R	10515812	0	0	0	3	3
3R	10558186	0	0	0	4	4
3R	10584920	0	18	0	51	69
3R	10585180	0	7	0	31	38
3R	10585186	0	7	0	31	38
3R	10766619	16	0	0	0	16
3R	10768515	0	17	0	137	154
3R	10776609	0	0	0	1	1
3R	10782974	0	0	0	65	65
3R	10871792	0	0	1	308	309
3R	11127820	0	0	0	174	174
3R	11193273	0	0	0	0	0
3R	11398476	17	0	12	0	29
3R	11398478	28	0	1	0	29
3R	11450201	0	0	0	0	0
3R	11589338	0	0	0	51	51
3R	11765112	0	14	0	58	72
3R	11801192	0	64	0	58	122
3R	11951530	144	0	61	0	205
3R	11951562	118	0	72	1	191
3R	11953544	355	0	0	0	355
3R	11985293	0	0	0	497	497
3R	11989608	0	0	0	12	12
3R	11994674	0	127	0	0	127
3R	12079394	0	1	0	11	12
3R	12079473	0	1	0	7	8
3R	12096226	20	0	0	0	20
3R	12163774	0	780	0	0	780
3R	12164347	0	168	0	580	748
3R	12215148	12	0	0	0	12
3R	12283052	0	0	0	0	0
3R	12411087	0	0	108	0	108
3R	12416318	43	0	0	0	43
3R	12516932	0	16	0	29	45
3R	12593574	0	1	0	23	24
3R	12593953	0	3	0	19	22
3R	12594802	0	2	0	16	18
3R	12705537	0	0	0	0	0
3R	12741372	0	0	0	0	0
3R	13004750	0	0	114	0	114
3R	13004828	0	0	146	0	146
3R	13018291	0	0	6	0	6
3R	13373289	0	0	0	711	711
3R	13382634	0	0	3	0	3
3R	13399579	0	0	0	306	306
3R	13462029	77	0	0	0	77
3R	13528966	0	0	0	0	0
3R	13663586	293	0	0	0	293
3R	13692592	54	0	58	0	112
3R	13692593	105	0	9	0	114
3R	13725311	0	0	0	0	0
3R	13782016	0	0	7	0	7
3R	13782327	0	0	0	0	0
3R	13959841	436	1	0	0	437
3R	13993445	0	0	0	0	0
3R	14105598	0	35	0	0	35
3R	14108210	0	0	0	16	16
3R	14128425	0	0	63	0	63
3R	14330746	0	54	0	0	54
3R	14363401	0	0	0	0	0
3R	14363405	0	0	0	0	0
3R	14395408	0	63	0	0	63
3R	14409075	0	64	0	0	64
3R	14515193	0	0	0	90	90
3R	14522391	950	0	0	1	951
3R	14623285	0	0	0	82	82
3R	14735962	0	0	0	1	1
3R	14746231	0	1	0	134	135
3R	14746547	0	0	0	227	227
3R	14747108	0	0	0	183	183
3R	14788816	99	0	0	0	99
3R	14809014	0	0	0	0	0
3R	14880381	7	0	0	0	7
3R	14891090	1606	1	0	0	1607
3R	14903154	0	4	0	0	4
3R	14919312	0	0	31	0	31
3R	14996135	0	0	0	1	1
3R	15097165	0	10	0	100	110
3R	15099803	0	0	0	115	115
3R	15287927	0	0	0	0	0
3R	15288163	12	0	0	0	12
3R	15294740	17	0	5	0	22
3R	15296683	810	0	16	0	826
3R	15296695	816	1	2	0	819
3R	15297732	3	0	1	0	4
3R	15298760	2	0	0	0	2
3R	15306860	17	0	0	0	17
3R	15306861	18	0	0	0	18
3R	15384375	13	0	1	0	14
3R	15387222	88	0	81	0	169
3R	15388396	77	0	88	0	165
3R	15392578	172	0	0	0	172
3R	15399446	100	0	122	0	222
3R	15400137	20	0	0	0	20
3R	15400209	9	0	3	0	12
3R	15400211	11	0	1	0	12
3R	15400224	0	0	8	2	10
3R	15401498	0	0	0	136	136
3R	15413254	101	0	143	0	244
3R	15413305	105	1	138	0	244
3R	15413827	238	1	0	0	239
3R	15822468	129	0	41	0	170
3R	15950619	0	0	0	4	4
3R	16003657	64	0	0	0	64
3R	16045954	0	0	0	9	9
3R	16065967	0	2	0	2	4
3R	16087664	0	0	0	0	0
3R	16096668	0	125	0	43	168
3R	16097238	0	48	0	87	135
3R	16302773	22	0	15	0	37
3R	16302775	16	0	20	0	36
3R	16303403	52	0	4	0	56
3R	16303415	49	0	10	0	59
3R	16502786	23	0	0	0	23
3R	16591505	0	0	0	0	0
3R	16633290	126	0	19	0	145
3R	16633369	45	0	59	0	104
3R	16809936	0	0	0	0	0
3R	16827828	0	0	0	0	0
3R	17140246	0	0	0	0	0
3R	17149369	0	0	0	12	12
3R	17502097	0	0	0	0	0
3R	17544578	108	0	43	0	151
3R	17544743	106	0	28	0	134
3R	17750942	0	0	0	8	8
3R	17750957	0	6	0	3	9
3R	17770919	0	0	0	73	73
3R	17771810	0	0	0	73	73
3R	17772922	0	0	0	100	100
3R	17773982	0	11	0	6	17
3R	17774217	0	63	0	24	87
3R	17774401	50	0	0	0	50
3R	17774920	0	0	0	5	5
3R	17775731	0	0	0	26	26
3R	17778660	0	0	0	9	9
3R	17795473	45	0	0	0	45
3R	17796092	21	0	0	0	21
3R	17796780	0	0	0	64	64
3R	17797297	0	0	0	77	77
3R	17799317	0	0	0	7	7
3R	17808359	0	0	0	27	27
3R	17809478	0	0	0	8	8
3R	17852526	39	0	0	0	39
3R	17865673	57	0	0	0	57
3R	17873639	0	61	0	92	153
3R	17874391	0	0	0	167	167
3R	17877415	0	0	0	161	161
3R	17881420	0	92	0	48	140
3R	17881807	0	0	1	162	163
3R	17882765	0	51	0	2	53
3R	17897257	0	5	0	9	14
3R	17905164	0	0	0	47	47
3R	17905999	0	0	0	59	59
3R	17908804	40	0	0	0	40
3R	17938630	0	0	0	0	0
3R	17944246	22	0	0	0	22
3R	17945071	2	0	0	0	2
3R	17945344	0	0	0	0	0
3R	17945752	0	0	0	0	0
3R	17946291	1	0	0	0	1
3R	17947397	37	0	0	0	37
3R	17949372	0	0	0	0	0
3R	17967291	0	0	67	0	67
3R	17967728	35	0	30	0	65
3R	17976866	0	0	1	0	1
3R	17980448	0	0	4	0	4
3R	17986938	1	0	0	0	1
3R	17992257	1	0	0	0	1
3R	17994037	1	0	0	0	1
3R	17994206	0	0	7	0	7
3R	18017356	38	0	0	0	38
3R	18133238	21	0	0	0	21
3R	18199189	0	0	0	13	13
3R	18205263	3	0	0	0	3
3R	18226004	0	0	0	22	22
3R	18236442	21	0	0	0	21
3R	18238159	98	0	0	0	98
3R	18290939	0	3	0	85	88
3R	18355194	0	18	0	10	28
3R	18355198	0	16	0	13	29
3R	18355305	1	18	0	13	32
3R	18360355	0	0	0	5	5
3R	18498021	0	0	0	0	0
3R	18599594	0	0	0	0	0
3R	18674009	10	0	0	0	10
3R	18801700	0	5	0	38	43
3R	18806029	0	2	0	16	18
3R	18824181	0	1	0	0	1
3R	18881308	0	0	0	0	0
3R	18907574	582	0	65	0	647
3R	18907652	194	0	478	0	672
3R	18907675	191	0	460	0	651
3R	18907799	279	0	134	0	413
3R	18907980	425	2	126	0	553
3R	18910005	244	0	11	0	255
3R	18910153	34	0	243	0	277
3R	18970679	296	0	11	0	307
3R	18970692	257	0	36	0	293
3R	18971312	136	0	215	0	351
3R	19081553	0	0	0	0	0
3R	19140149	0	21	0	71	92
3R	19141001	0	20	0	115	135
3R	19218093	0	0	0	1	1
3R	19231096	0	39	0	333	372
3R	19231097	0	100	0	271	371
3R	19231100	0	28	0	338	366
3R	19238197	0	71	0	197	268
3R	19238358	0	71	0	177	248
3R	19238845	0	37	0	158	195
3R	19389278	0	0	0	1	1
3R	19579291	0	0	2	0	2
3R	19637450	0	0	0	52	52
3R	19643921	0	30	0	0	30
3R	19653645	1	80	0	0	81
3R	19660641	0	0	1	0	1
3R	19662383	0	0	46	0	46
3R	19662407	0	0	40	0	40
3R	19734535	0	0	0	0	0
3R	19753763	24	0	78	0	102
3R	19753764	8	0	94	0	102
3R	19763634	31	0	124	0	155
3R	19765660	72	0	32	0	104
3R	19766576	0	0	102	0	102
3R	19836444	0	0	0	0	0
3R	19840656	0	0	0	0	0
3R	19847652	38	0	0	0	38
3R	19848089	21	0	0	0	21
3R	19848545	28	0	0	0	28
3R	19850222	164	0	0	0	164
3R	19901320	0	1	0	253	254
3R	19901682	0	1	0	212	213
3R	19914707	0	0	0	729	729
3R	19977151	0	0	0	0	0
3R	20037752	0	6	0	21	27
3R	20253305	20	0	0	0	20
3R	20253308	19	0	1	0	20
3R	20254800	0	0	0	0	0
3R	20322199	118	0	78	0	196
3R	20323426	123	0	0	0	123
3R	20397317	0	0	0	5	5
3R	20397347	0	0	0	4	4
3R	20397348	0	0	0	4	4
3R	20397350	0	0	0	4	4
3R	20397351	0	0	0	3	3
3R	20397356	0	0	0	3	3
3R	20397361	0	0	0	3	3
3R	20397362	0	0	0	3	3
3R	20397364	0	0	0	3	3
3R	20397502	0	1	0	2	3
3R	20397510	0	2	0	2	4
3R	20397511	0	1	0	3	4
3R	20397525	0	2	0	2	4
3R	20397526	0	2	0	2	4
3R	20397527	0	1	0	3	4
3R	20442288	0	0	0	0	0
3R	20538040	0	0	0	15	15
3R	20964328	1618	0	784	1	2403
3R	20965039	1396	0	846	0	2242
3R	20978916	80	0	16	0	96
3R	20986865	0	0	0	0	0
3R	20993738	100	0	208	0	308
3R	20993841	98	0	174	0	272
3R	20993853	158	0	125	0	283
3R	21010468	64	0	12	0	76
3R	21010472	66	0	11	0	77
3R	21018588	17	0	77	0	94
3R	21018593	79	0	4	0	83
3R	21018596	27	0	54	0	81
3R	21018660	44	0	57	0	101
3R	21018693	12	0	91	0	103
3R	21018789	83	0	9	0	92
3R	21020302	41	0	18	0	59
3R	21020304	51	0	7	0	58
3R	21020562	19	0	22	0	41
3R	21032796	0	0	0	1	1
3R	21034155	0	0	0	0	0
3R	21035203	0	0	0	0	0
3R	21035311	0	0	0	0	0
3R	21036317	0	0	0	1	1
3R	21210519	16	0	0	0	16
3R	21213783	79	0	10	0	89
3R	21216016	95	0	0	0	95
3R	21228047	9	0	48	0	57
3R	21228182	22	0	45	0	67
3R	21268995	0	0	0	274	274
3R	21275768	0	445	0	0	445
3R	21277235	0	3	0	13	16
3R	21297848	425	0	57	0	482
3R	21316786	0	0	0	1	1
3R	21337167	0	5	0	20	25
3R	21360556	0	0	0	1	1
3R	21580556	0	2	0	0	2
3R	21795674	0	0	0	1	1
3R	21866357	0	4	0	0	4
3R	21979019	0	0	0	0	0
3R	22782190	3	0	1	0	4
3R	22784953	36	0	0	0	36
3R	23061604	26	0	0	0	26
3R	23081390	0	0	0	709	709
3R	23092053	0	0	0	0	0
3R	23112549	0	0	0	654	654
3R	23124996	0	10	0	0	10
3R	23124998	0	0	0	11	11
3R	23125099	0	0	0	16	16
3R	23125127	0	0	0	16	16
3R	23125179	0	0	0	19	19
3R	23125191	0	16	0	0	16
3R	23180642	0	0	0	0	0
3R	23183620	0	0	29	0	29
3R	23188969	0	264	0	0	264
3R	23191853	0	158	0	0	158
3R	23200370	0	0	0	19	19
3R	23228940	0	0	0	182	182
3R	23229652	0	0	0	80	80
3R	23229765	0	0	0	122	122
3R	23245868	0	0	0	1	1
3R	23248865	0	0	0	51	51
3R	23252005	2	0	0	0	2
3R	23261644	0	12	0	6	18
3R	23348613	0	0	0	0	0
3R	23348619	0	0	0	0	0
3R	23348769	0	0	0	0	0
3R	23348836	2	0	0	0	2
3R	23349750	2	0	0	0	2
3R	23355233	0	0	0	7	7
3R	23379528	0	0	0	33	33
3R	23662171	0	0	0	0	0
3R	23662433	0	0	0	0	0
3R	23806927	0	0	0	26	26
3R	23807724	0	0	0	29	29
3R	23812871	0	0	0	96	96
3R	23847794	113	0	0	0	113
3R	23848537	62	0	50	0	112
3R	23889222	0	6	0	0	6
3R	23889403	0	1	0	0	1
3R	23903183	0	0	0	56	56
3R	23906410	0	0	0	0	0
3R	23913774	0	0	0	0	0
3R	23930726	0	0	0	161	161
3R	23936205	0	0	0	865	865
3R	23941852	0	0	0	6	6
3R	23954031	0	0	0	42	42
3R	23954205	0	0	0	45	45
3R	23954270	0	0	0	43	43
3R	23975656	9	0	0	0	9
3R	23976395	260	0	0	0	260
3R	23981667	49	0	37	0	86
3R	23982357	215	0	58	0	273
3R	23983504	419	0	28	0	447
3R	23999913	0	0	0	134	134
3R	24000236	0	0	1	186	187
3R	24000858	0	4	0	27	31
3R	24028532	0	0	0	0	0
3R	24028545	0	0	0	0	0
3R	24035862	0	0	0	90	90
3R	24038324	40	0	0	0	40
3R	24051777	266	0	0	0	266
3R	24059369	26	0	0	0	26
3R	24059405	25	0	0	0	25
3R	24063411	24	0	0	0	24
3R	24065016	0	0	0	18	18
3R	24079314	0	0	0	0	0
3R	24080205	0	0	0	0	0
3R	24080856	0	0	0	0	0
3R	24089901	0	2	0	0	2
3R	24094522	0	0	0	5	5
3R	24096044	0	0	0	4	4
3R	24103714	0	52	0	134	186
3R	24115231	0	239	0	0	239
3R	24136443	48	0	0	0	48
3R	24136633	33	0	0	0	33
3R	24136663	27	0	0	0	27
3R	24141432	32	0	0	0	32
3R	24157937	0	0	0	72	72
3R	24162927	0	0	0	13	13
3R	24214769	0	0	0	0	0
3R	24228774	0	12	0	0	12
3R	24235203	2	0	0	0	2
3R	24292106	58	0	0	0	58
3R	24308629	53	0	0	0	53
3R	24309492	100	0	0	0	100
3R	24311331	18	0	37	0	55
3R	24399715	15	0	0	0	15
3R	24401818	0	15	0	30	45
3R	24511651	0	23	0	104	127
3R	24511656	0	29	0	96	125
3R	24512020	0	8	0	14	22
3R	24512901	0	0	0	19	19
3R	24512911	0	1	0	19	20
3R	24600699	0	0	0	0	0
3R	24668815	26	0	0	0	26
3R	24674513	98	0	5	0	103
3R	24675475	17	0	4	0	21
3R	24675663	15	0	62	0	77
3R	24690643	4	0	1	0	5
3R	24691493	97	0	6	0	103
3R	24692577	3	0	6	0	9
3R	24697793	8	0	4	0	12
3R	24706551	22	0	138	0	160
3R	24707423	47	0	84	0	131
3R	24707696	93	0	51	0	144
3R	24707890	147	0	28	0	175
3R	24708326	66	0	33	0	99
3R	24708329	75	0	24	1	100
3R	24708330	66	0	30	0	96
3R	24708356	70	0	21	0	91
3R	24829203	0	0	0	94	94
3R	25026672	31	0	0	0	31
3R	25039627	283	1	0	0	284
3R	25134628	0	0	1	0	1
3R	25136056	55	0	0	0	55
3R	25268354	0	0	2	0	2
3R	25346655	0	0	0	594	594
3R	25516393	0	0	0	0	0
3R	25530500	0	0	0	0	0
3R	25607422	0	0	0	5	5
3R	25680862	96	0	0	0	96
3R	25871448	31	0	0	0	31
3R	25871506	26	0	0	0	26
3R	25871531	25	0	0	0	25
3R	25871712	39	0	1	0	40
3R	25871911	37	0	1	0	38
3R	25965631	263	0	27	0	290
3R	25965643	1	0	296	0	297
3R	26275388	37	0	5	0	42
3R	26344955	0	1	0	0	1
3R	26384361	0	0	0	0	0
3R	26533202	0	0	0	1	1
3R	26533203	0	0	0	1	1
3R	26533204	0	0	0	1	1
3R	26533205	0	0	0	0	0
3R	26544601	0	0	0	0	0
3R	26555239	0	0	107	0	107
3R	26572578	3	0	0	0	3
3R	26593045	7	0	0	0	7
3R	26601314	0	0	117	0	117
3R	26681389	0	0	0	53	53
3R	26698436	0	0	0	244	244
3R	26699744	1	476	0	0	477
3R	26703453	0	0	0	8	8
3R	26706990	0	0	0	0	0
3R	26707060	0	0	0	0	0
3R	26710227	0	0	0	0	0
3R	26710639	0	0	0	0	0
3R	26711278	0	0	0	2	2
3R	26711482	0	0	0	0	0
3R	26722743	0	0	0	68	68
3R	26799601	1	0	0	0	1
3R	26803090	0	0	0	0	0
3R	26839293	0	0	83	0	83
3R	26839692	0	0	81	0	81
3R	26854725	0	0	0	1	1
3R	26869981	0	0	1	1074	1075
3R	26870035	0	0	1	1141	1142
3R	26898498	0	0	0	0	0
3R	26922349	0	0	0	0	0
3R	26941648	79	0	0	0	79
3R	26942517	121	1	0	0	122
3R	26950965	0	0	0	482	482
3R	26964540	0	0	0	12	12
3R	26971309	42	0	0	0	42
3R	27006713	0	0	0	0	0
3R	27059393	0	0	0	0	0
3R	27065920	0	0	1	77	78
3R	27065932	0	0	0	69	69
3R	27101403	0	0	0	24	24
3R	27155499	379	0	0	0	379
3R	27159080	57	0	0	0	57
3R	27237462	0	0	0	117	117
3R	27255644	111	0	0	0	111
3R	27260195	0	0	0	64	64
3R	27275221	4	0	1	0	5
3R	27436670	0	1	0	32	33
3R	27581330	0	0	0	2	2
3R	27610850	1	0	1	0	2
3R	27643914	0	36	0	272	308
3R	27669340	107	0	57	0	164
3R	27673172	126	0	117	0	243
3R	27673289	35	0	231	0	266
3R	27674209	0	0	209	0	209
3R	27674284	0	0	205	0	205
3R	27674568	98	0	144	0	242
3R	27674719	212	0	88	0	300
3R	27674736	33	0	261	0	294
3R	27674878	60	0	222	0	282
3R	27674907	122	0	172	0	294
3R	27675074	251	0	84	0	335
3R	27676160	300	0	56	0	356
3R	27676232	162	0	116	0	278
3R	27923909	3	0	0	0	3
3R	27928133	0	0	0	14	14
3R	27949844	150	0	0	0	150
3R	27954914	0	2	0	0	2
3R	27955650	0	0	9	0	9
3R	27956797	14	0	0	0	14
3R	27957947	0	21	0	0	21
3R	27965771	22	1	0	0	23
3R	27965792	23	0	0	0	23
3R	27966580	0	0	18	0	18
3R	27987451	0	0	0	0	0
3R	28077291	0	0	0	0	0
3R	28211257	0	0	1	0	1
3R	28418412	102	0	0	0	102
3R	28598794	0	18	0	28	46
3R	28630348	0	0	0	0	0
3R	28740661	0	0	0	0	0
3R	28755588	0	0	0	0	0
3R	28755612	0	0	0	0	0
3R	28824334	10	0	0	0	10
3R	28825660	0	0	0	82	82
3R	28834732	0	0	0	84	84
3R	28841035	0	0	0	0	0
3R	28842883	0	1	0	0	1
3R	28845314	0	8	0	0	8
3R	28845906	0	0	34	0	34
3R	28874903	58	0	0	0	58
3R	28877734	0	0	0	19	19
3R	28883203	0	0	0	0	0
3R	28893176	0	0	34	0	34
3R	28903133	16	0	0	0	16
3R	28910138	35	0	0	0	35
3R	28925501	0	0	0	48	48
3R	29682986	6	0	3	0	9
3R	29725169	44	0	0	0	44
3R	29809019	0	0	12	0	12
3R	29852709	33	0	0	0	33
3R	29877130	101	0	0	0	101
3R	29877330	30	0	0	0	30
3R	29877364	31	0	0	0	31
3R	29990367	28	0	0	0	28
3R	29991674	0	0	0	30	30
3R	30002686	0	0	0	89	89
3R	30012340	0	0	0	8	8
3R	30012471	0	0	0	7	7
3R	30014618	0	0	0	7	7
3R	30036766	0	0	0	18	18
3R	30040555	32	0	0	0	32
3R	30083131	6	0	0	0	6
3R	30092365	12	0	0	0	12
3R	30103150	44	0	0	0	44
3R	30104256	216	2	0	0	218
3R	30112301	249	0	0	0	249
3R	30113784	79	0	0	0	79
3R	30114780	46	0	0	0	46
3R	30115158	35	0	0	0	35
3R	30199030	0	0	0	0	0
3R	30303048	1	0	0	0	1
3R	30420927	0	0	0	95	95
3R	30774448	0	0	27	0	27
3R	30796901	0	1	0	0	1
3R	31046504	14	0	0	0	14
3R	31160434	3	0	0	0	3
3R	31228686	75	0	41	0	116
3R	31597431	0	53	0	278	331
3R	31597432	0	84	0	240	324
3R	31599016	0	77	0	753	830
3R	31601718	0	201	0	423	624
3R	31601828	1	159	0	826	986
3R	31602191	0	179	0	1069	1248
3R	31608331	0	5	0	20	25
3R	31724907	1	0	0	0	1
3R	31837086	14	0	20	0	34
3R	31837089	5	0	28	0	33
3R	31844215	30	0	21	0	51
3R	31844748	49	0	19	0	68
4	55144	0	0	0	3	3
4	76506	1	0	0	0	1
4	86500	0	0	0	0	0
4	100011	21	0	0	0	21
4	100035	7	0	10	0	17
4	100181	1	0	14	0	15
4	100197	7	0	6	0	13
4	100200	12	0	3	0	15
4	100204	10	0	4	0	14
4	100214	12	0	1	0	13
4	100219	8	0	2	0	10
4	100289	23	0	4	0	27
4	100442	37	0	3	0	40
4	100530	36	0	3	0	39
4	100539	33	0	6	0	39
4	100543	21	0	18	0	39
4	100547	39	0	0	0	39
4	100549	22	0	19	0	41
4	100554	31	0	7	0	38
4	100556	35	0	0	0	35
4	100557	23	0	12	0	35
4	100558	31	0	4	0	35
4	100559	28	0	7	0	35
4	100560	9	0	26	0	35
4	100563	5	0	28	0	33
4	100629	11	0	10	0	21
4	101660	9	0	36	0	45
4	102327	22	0	16	0	38
4	102349	16	0	16	0	32
4	113007	71	0	31	0	102
4	126831	0	1	0	0	1
4	126842	0	0	0	1	1
4	128747	0	0	0	3	3
4	182444	0	0	0	7	7
4	182525	0	4	0	8	12
4	191689	0	13	0	13	26
4	191704	0	15	0	12	27
4	191708	0	8	0	20	28
4	192653	0	2	0	13	15
4	192661	0	14	0	5	19
4	192670	0	15	0	14	29
4	192672	0	5	0	25	30
4	192677	0	18	0	9	27
4	192684	0	8	0	22	30
4	192692	0	14	0	15	29
4	192715	0	20	0	15	35
4	192723	0	9	0	24	33
4	192724	0	14	0	21	35
4	213353	13	0	19	0	32
4	213371	27	0	7	0	34
4	214241	23	0	10	0	33
4	234621	1	0	1	0	2
4	234717	5	0	0	0	5
4	234747	1	0	4	0	5
4	234775	6	0	0	0	6
4	234798	5	0	0	0	5
4	235270	6	0	0	0	6
4	235273	3	0	2	0	5
4	235277	5	0	1	0	6
4	235278	6	0	0	0	6
4	235280	4	0	0	0	4
4	235284	5	0	1	0	6
4	235287	0	0	6	0	6
4	235308	6	0	0	0	6
4	235309	6	0	0	0	6
4	235310	4	0	2	0	6
4	235311	4	0	2	0	6
4	235313	3	0	3	0	6
4	235317	5	0	1	0	6
4	235319	6	0	0	0	6
4	235336	6	0	0	0	6
4	235338	4	0	2	0	6
4	235343	5	0	0	0	5
4	235344	5	0	0	0	5
4	235495	3	0	0	0	3
4	235496	2	0	1	0	3
4	235506	2	0	0	0	2
4	265270	24	0	0	0	24
4	265273	25	0	0	0	25
4	292019	0	0	0	1	1
4	292441	0	2	0	0	2
4	294654	0	2	0	2	4
4	295725	0	1	0	1	2
4	304161	0	2	0	0	2
4	328580	0	10	0	10	20
4	339075	0	8	0	15	23
4	340376	0	10	0	8	18
4	340381	0	4	0	14	18
4	340398	0	7	0	12	19
4	341198	0	1	0	9	10
4	341200	0	1	0	9	10
4	343860	0	1	0	0	1
4	351351	0	1	0	6	7
4	351417	0	1	0	1	2
4	356697	0	1	0	0	1
4	356702	0	0	0	1	1
4	356711	0	1	0	0	1
4	356722	0	1	0	0	1
4	356723	0	1	0	0	1
4	356726	0	1	0	0	1
4	356734	0	0	0	1	1
4	356773	0	2	0	0	2
4	357621	0	1	0	0	1
4	357626	0	0	0	1	1
4	357672	0	1	0	0	1
4	357673	0	1	0	0	1
4	367899	9	0	2	0	11
4	403085	1	0	0	0	1
4	446514	99	0	24	2	125
4	446530	97	1	24	3	125
4	448154	33	0	12	0	45
4	448773	36	0	13	0	49
4	449601	93	0	6	0	99
4	449602	87	0	8	0	95
4	449672	79	0	14	0	93
4	449705	83	0	5	0	88
4	449711	79	0	8	0	87
4	449740	70	0	13	0	83
4	449751	56	0	23	0	79
4	449767	63	0	16	0	79
4	454069	106	0	6	0	112
4	454073	102	0	4	0	106
4	454076	87	0	17	0	104
4	454085	80	0	21	0	101
4	455119	4	0	7	0	11
4	455123	7	0	4	0	11
4	455582	12	0	6	0	18
4	455778	10	0	0	0	10
4	459603	25	0	1	0	26
4	459637	20	0	0	0	20
4	476665	0	5	0	10	15
4	476688	0	6	0	6	12
4	476701	0	10	0	2	12
4	476921	0	5	0	11	16
4	520535	0	0	1	0	1
4	541492	0	13	0	25	38
4	541536	0	25	0	16	41
4	541538	0	12	0	29	41
4	541539	0	33	0	7	40
4	541545	0	6	0	34	40
4	541585	0	16	0	20	36
4	541776	0	12	0	19	31
4	541778	0	18	0	13	31
4	541780	0	1	0	29	30
4	541782	0	18	0	12	30
4	541784	0	16	0	15	31
4	541793	28	0	0	0	28
4	541795	0	3	0	27	30
4	541819	0	0	0	25	25
4	541822	0	4	0	23	27
4	541825	0	3	0	25	28
4	541826	0	3	0	24	27
4	541828	0	2	0	22	24
4	541882	0	2	0	26	28
4	541884	0	1	0	28	29
4	541886	0	4	0	24	28
4	541887	0	5	0	23	28
4	541889	0	2	0	26	28
4	541890	0	3	0	25	28
4	560912	42	0	3	0	45
4	560934	37	0	10	0	47
4	561097	26	0	5	0	31
4	563220	15	0	0	0	15
4	563252	13	0	0	0	13
4	563258	11	0	0	0	11
4	563274	11	0	0	0	11
4	563284	9	0	0	0	9
4	563291	0	0	0	0	0
4	563330	0	0	0	0	0
4	563333	0	0	0	0	0
4	563340	0	0	0	0	0
4	563347	0	0	0	0	0
4	563352	0	0	0	0	0
4	563354	0	0	0	0	0
4	563367	0	0	0	0	0
4	563368	0	0	0	0	0
4	563369	0	0	0	0	0
4	563370	0	0	0	0	0
4	563373	0	0	0	0	0
4	563377	0	0	0	0	0
4	563380	0	0	0	0	0
4	563383	0	0	0	0	0
4	563384	0	0	0	0	0
4	563385	0	0	0	0	0
4	563386	0	0	0	0	0
4	563390	0	0	0	0	0
4	563396	0	0	0	0	0
4	563398	0	0	0	0	0
4	563399	0	0	0	0	0
4	563401	0	0	0	0	0
4	563402	0	0	0	0	0
4	563403	0	0	0	0	0
4	563405	0	0	0	0	0
4	563409	0	0	0	0	0
4	563414	0	0	0	0	0
4	563416	0	0	0	0	0
4	563537	0	0	0	0	0
4	579932	12	0	0	0	12
4	579972	11	0	0	0	11
4	579974	9	0	0	0	9
4	579978	9	0	0	0	9
4	579980	10	0	1	0	11
4	602510	0	4	0	6	10
4	612525	9	0	0	0	9
4	636945	0	3	0	3	6
4	638429	0	0	0	4	4
4	653771	0	0	0	0	0
4	654895	0	7	0	16	23
4	654898	0	7	0	15	22
4	659412	0	1	0	38	39
4	667083	29	0	0	0	29
4	667084	23	0	6	0	29
4	667085	24	0	5	0	29
4	667101	15	0	9	0	24
4	667104	16	0	7	0	23
4	668200	24	0	2	0	26
4	668202	12	0	14	0	26
4	686912	42	0	7	1	50
4	686921	36	0	14	0	50
4	686924	40	0	11	0	51
4	686926	47	0	4	0	51
4	686929	25	0	26	0	51
4	686932	29	0	22	0	51
4	686941	48	0	2	0	50
4	686958	38	0	7	0	45
4	686973	44	0	4	0	48
4	686981	46	0	4	0	50
4	687294	10	0	15	0	25
4	688162	40	0	10	0	50
4	725144	0	0	0	0	0
4	743070	38	0	2	0	40
4	744196	1	0	0	0	1
4	744197	1	0	0	0	1
4	744213	1	0	0	0	1
4	744215	1	0	0	0	1
4	744797	0	0	0	0	0
4	744886	0	0	0	0	0
4	744897	0	0	0	0	0
4	745047	1	0	0	0	1
4	745107	1	0	0	0	1
4	747687	39	0	1	0	40
4	747738	26	0	16	0	42
4	767187	129	0	6	0	135
4	767264	110	0	6	0	116
4	823281	0	0	0	2	2
4	856273	0	0	0	15	15
4	856282	0	1	0	13	14
4	856311	0	10	0	8	18
4	856324	0	0	0	17	17
4	856326	0	8	0	9	17
4	856328	0	2	0	14	16
4	856331	0	0	0	18	18
4	856359	0	10	0	4	14
4	856373	0	2	0	13	15
4	857770	0	10	0	5	15
4	858835	0	7	0	3	10
4	858841	0	2	0	10	12
4	860159	0	6	0	10	16
4	860173	0	7	0	10	17
4	860227	0	8	0	6	14
4	860232	0	3	0	11	14
4	860236	0	1	0	13	14
4	874383	0	187	0	124	311
4	878970	0	105	0	294	399
4	879448	0	9	0	41	50
4	879496	0	32	0	11	43
4	879936	0	7	0	72	79
4	882370	0	33	0	51	84
4	889066	0	39	0	18	57
4	895648	0	0	0	1	1
4	896129	0	0	0	2	2
4	896139	0	0	0	1	1
4	896192	0	1	0	1	2
4	897223	0	2	0	1	3
4	897246	0	0	0	4	4
4	897262	0	1	0	2	3
4	897309	0	3	0	1	4
4	908982	0	0	0	7	7
4	980493	0	0	0	0	0
4	980622	0	0	0	0	0
4	999228	14	0	3	0	17
4	1039524	0	6	0	70	76
4	1039649	0	2	0	48	50
4	1040392	0	3	0	82	85
4	1040397	0	14	0	71	85
4	1041214	0	65	0	87	152
4	1041225	0	81	0	104	185
4	1041307	0	116	0	67	183
4	1041381	0	28	0	141	169
4	1041388	0	46	0	123	169
4	1041389	0	19	0	147	166
4	1041395	0	39	0	121	160
4	1041418	0	12	0	149	161
4	1041449	0	19	0	123	142
4	1041451	0	67	0	77	144
4	1041452	0	22	0	126	148
4	1041464	0	2	1	133	136
4	1041465	0	14	0	119	133
4	1041478	0	32	0	91	123
4	1041482	0	27	0	102	129
4	1041483	0	6	0	122	128
4	1041494	0	67	0	50	117
4	1041500	0	15	0	100	115
4	1041514	0	28	0	94	122
4	1041521	0	20	0	105	125
4	1041544	0	31	0	87	118
4	1042206	0	37	0	98	135
4	1042231	0	26	0	115	141
4	1042257	0	38	0	106	144
4	1042367	0	19	0	170	189
4	1042368	0	20	0	168	188
4	1042371	0	88	0	99	187
4	1042502	0	78	0	93	171
4	1042610	0	83	0	70	153
4	1042667	0	22	0	133	155
4	1042794	0	8	0	137	145
4	1042907	0	25	0	100	125
4	1042971	0	11	0	102	113
4	1042975	0	23	0	90	113
4	1045395	0	0	0	1	1
4	1045396	0	0	0	1	1
4	1046984	0	2	0	8	10
4	1046986	0	2	0	8	10
4	1046987	0	1	0	10	11
4	1051636	0	5	0	10	15
4	1052332	0	1	0	3	4
4	1125511	0	0	2	0	2
4	1125515	1	0	1	0	2
4	1125529	0	0	1	0	1
4	1125587	1	0	0	0	1
4	1125632	0	0	0	0	0
4	1126049	3	0	0	0	3
4	1126064	4	0	0	0	4
4	1126065	2	0	2	0	4
4	1126078	2	0	2	0	4
4	1126349	4	0	2	0	6
4	1132912	20	0	11	0	31
4	1132913	25	0	6	0	31
4	1132915	8	0	22	0	30
4	1132917	23	0	7	0	30
4	1132932	28	0	5	0	33
4	1132946	12	0	22	0	34
4	1133654	4	0	50	0	54
4	1133655	34	0	21	0	55
4	1134443	133	0	53	0	186
4	1134452	158	0	22	0	180
4	1134469	116	0	67	0	183
4	1134830	95	0	26	0	121
4	1134861	29	0	74	0	103
4	1134869	97	0	14	0	111
4	1136039	27	0	9	0	36
4	1136068	32	0	3	0	35
4	1137308	3	0	26	0	29
4	1148236	4	0	0	0	4
4	1148466	0	0	1	0	1
4	1168877	8	0	5	0	13
4	1232612	4	0	0	0	4
4	1232942	7	0	0	0	7
4	1234422	14	0	3	0	17
4	1234429	12	0	5	0	17
4	1244706	3	0	21	0	24
4	1244726	10	0	11	0	21
4	1244727	11	0	10	0	21
4	1252829	14	0	32	0	46
4	1252993	45	0	7	0	52
4	1254576	30	0	14	0	44
4	1255125	29	0	2	0	31
4	1255131	16	0	14	0	30
4	1255132	26	0	3	0	29
4	1255154	21	0	8	0	29
4	1255163	29	0	2	0	31
4	1255168	23	0	8	0	31
4	1257070	13	0	10	0	23
4	1257336	21	0	1	0	22
4	1257543	7	0	7	0	14
4	1257984	40	0	3	0	43
4	1260280	1	0	7	0	8
4	1260284	6	0	4	0	10
4	1265107	211	0	221	0	432
4	1267648	2	0	0	0	2
Un_DS483999v1	2471	0	0	0	0	0
Un_DS484083v1	1024	0	0	0	0	0
Un_DS484090v1	1859	0	0	0	0	0
Un_DS484176v1	2586	0	0	0	0	0
Un_DS484511v1	1204	0	0	0	0	0
Un_DS484539v1	1135	0	0	0	0	0
Un_DS484746v1	578	0	0	0	0	0
Un_DS485536v1	813	0	0	0	0	0
Un_DS485605v1	551	0	0	0	0	0
X	514252	0	26	0	33	59
X	514297	0	11	0	50	61
X	514298	0	14	0	45	59
X	516944	0	2	0	47	49
X	516949	0	6	0	42	48
X	516964	0	12	0	40	52
X	923306	0	0	0	100	100
X	923307	0	0	0	105	105
X	924277	0	76	0	57	133
X	1373346	219	0	102	0	321
X	1373528	132	0	126	0	258
X	1373589	183	0	41	0	224
X	1373602	192	0	39	0	231
X	1378095	269	0	46	0	315
X	1378279	195	0	90	0	285
X	1378284	163	1	121	0	285
X	1491577	0	25	0	31	56
X	1676057	0	124	0	17	141
X	1676066	0	43	0	98	141
X	1676597	0	160	0	32	192
X	1690573	0	69	0	134	203
X	1781840	58	0	63	0	121
X	1784005	39	0	45	1	85
X	1784034	62	0	32	0	94
X	1784035	71	0	18	0	89
X	1784036	56	0	34	0	90
X	1785204	155	0	11	0	166
X	1785212	148	0	14	0	162
X	1785216	128	0	40	0	168
X	1785256	123	0	2	0	125
X	1785441	106	0	3	0	109
X	1785444	111	0	0	0	111
X	1785543	95	0	7	0	102
X	1785888	39	0	48	0	87
X	1785903	70	0	9	0	79
X	1786528	112	0	2	0	114
X	1854163	0	0	0	0	0
X	1854164	0	0	0	0	0
X	2078771	0	0	0	77	77
X	2112342	155	0	52	0	207
X	2112355	183	0	30	0	213
X	2112356	163	0	52	0	215
X	2180389	0	0	0	0	0
X	2219688	0	10	0	10	20
X	2376647	0	33	0	25	58
X	2434676	0	0	0	3	3
X	2515228	0	0	0	2	2
X	2625116	0	0	0	0	0
X	2628866	72	0	134	0	206
X	2660761	140	0	0	0	140
X	2667642	1	0	1	0	2
X	2677613	169	0	4	0	173
X	2678338	124	0	10	0	134
X	2678342	111	0	24	0	135
X	3297989	6	0	0	0	6
X	3342781	6	0	0	0	6
X	3343393	32	0	0	0	32
X	3477696	0	0	0	67	67
X	3719089	0	1	0	4	5
X	3730329	2	0	0	0	2
X	3859628	0	389	0	1967	2356
X	3859645	0	517	0	1730	2247
X	3860640	1	309	1	2132	2443
X	3860692	0	333	1	2206	2540
X	3860693	0	1155	0	1366	2521
X	3860694	0	237	0	2309	2546
X	3861312	6	194	1	1710	1911
X	3861498	1	432	4	1731	2168
X	3861499	0	403	4	1708	2115
X	3861500	1	203	0	1981	2185
X	3861501	2	1733	0	357	2092
X	3861505	0	1455	0	623	2078
X	3895378	0	1	0	39	40
X	3953264	191	0	61	0	252
X	4102802	0	0	0	0	0
X	4217290	0	0	0	0	0
X	4352383	5	0	1	0	6
X	4356397	70	0	2	0	72
X	4689184	0	0	0	0	0
X	4689563	0	0	0	0	0
X	4701126	0	1	0	231	232
X	4711852	0	0	0	0	0
X	4981377	0	0	0	0	0
X	5087477	2	0	5	0	7
X	5170349	14	0	1	0	15
X	5239523	41	0	8	0	49
X	5251934	0	0	0	78	78
X	5252342	25	0	10	0	35
X	5360710	5	0	0	0	5
X	5396519	27	0	13	0	40
X	5397332	2	0	7	0	9
X	5397347	9	0	3	0	12
X	5397612	4	0	1	0	5
X	5630114	0	339	0	60	399
X	5630195	0	35	0	377	412
X	5630213	0	223	0	206	429
X	5630234	0	321	0	80	401
X	5630342	1	193	0	189	383
X	5630737	0	42	3	294	339
X	5631026	0	146	2	131	279
X	5631035	0	233	0	37	270
X	5631048	0	251	0	57	308
X	5788690	0	0	20	0	20
X	5810061	0	0	0	0	0
X	5963943	0	1	0	0	1
X	5998043	0	0	0	28	28
X	6105139	1	5	0	131	137
X	6107611	0	98	0	258	356
X	6107620	0	175	0	188	363
X	6107716	0	85	0	49	134
X	6108552	1	232	0	52	285
X	6108553	0	262	0	20	282
X	6108712	0	190	0	9	199
X	6108766	0	81	0	144	225
X	6109871	0	46	0	215	261
X	6112645	0	14	0	153	167
X	6115425	0	180	0	27	207
X	6145386	0	26	0	128	154
X	6184321	0	0	0	0	0
X	6531547	0	0	0	0	0
X	6537186	0	0	14	0	14
X	6577785	3	0	1	0	4
X	6790259	0	3	0	6	9
X	7085816	0	94	0	29	123
X	7445827	11	0	12	0	23
X	7698223	0	0	0	0	0
X	7912801	65	0	0	0	65
X	7938121	0	0	0	0	0
X	7987553	0	0	0	0	0
X	8046474	0	0	0	13	13
X	8055921	0	0	0	0	0
X	8055924	0	0	0	0	0
X	8240090	38	0	77	0	115
X	8240161	84	0	34	0	118
X	8247628	290	0	176	0	466
X	8272518	0	2	0	5	7
X	8403319	11	0	25	0	36
X	8409426	0	0	0	22	22
X	8518112	5	0	2	0	7
X	8632440	0	24	0	34	58
X	8649283	0	4	0	2	6
X	8908884	0	2	0	0	2
X	8910271	0	2	0	1	3
X	8917312	4	0	0	0	4
X	8927652	1	0	0	0	1
X	8927665	0	0	0	0	0
X	8941468	4	0	1	0	5
X	8942088	3	0	0	0	3
X	8942812	2	0	0	0	2
X	8966417	2	0	0	0	2
X	9002119	0	0	0	0	0
X	9020223	11	0	39	0	50
X	9020239	19	0	28	0	47
X	9020384	4	0	49	0	53
X	9022297	0	0	0	95	95
X	9022830	82	0	11	0	93
X	9022835	22	0	66	0	88
X	9022869	13	0	50	0	63
X	9022902	58	0	3	0	61
X	9022931	35	0	47	0	82
X	9022942	57	0	28	0	85
X	9022943	74	0	11	0	85
X	9028080	109	0	81	0	190
X	9028091	94	0	86	0	180
X	9037319	0	0	0	0	0
X	9153487	2	217	0	1767	1986
X	9200948	0	0	0	1	1
X	9278576	0	13	0	31	44
X	9340169	0	0	0	0	0
X	9574655	0	77	0	16	93
X	9754490	3	0	11	0	14
X	10016995	0	0	0	1	1
X	10247964	0	2	0	27	29
X	10330625	0	0	0	0	0
X	10356486	223	0	0	0	223
X	10463690	58	0	0	0	58
X	10639732	0	0	0	0	0
X	10709480	71	0	11	0	82
X	10711327	0	0	0	31	31
X	10711351	0	0	0	31	31
X	10746485	137	0	40	0	177
X	10746488	118	0	52	0	170
X	10817179	0	0	0	2	2
X	10835849	0	81	0	33	114
X	10846781	0	47	0	56	103
X	11047667	6	0	2	0	8
X	11047679	5	0	3	0	8
X	11047750	0	0	7	0	7
X	11047753	2	0	5	0	7
X	11048103	3	0	8	0	11
X	11052798	0	257	0	210	467
X	11221249	0	1	0	22	23
X	11221253	0	0	0	25	25
X	11221255	0	2	0	21	23
X	11221259	0	2	0	20	22
X	11221261	0	0	0	24	24
X	11221263	0	0	0	23	23
X	11221265	0	0	0	20	20
X	11221267	0	0	0	23	23
X	11221296	0	6	0	22	28
X	11221308	0	1	0	28	29
X	11221310	0	0	0	29	29
X	11221312	0	0	0	28	28
X	11221318	0	2	0	25	27
X	11221322	0	3	0	25	28
X	11221325	0	4	0	22	26
X	11224387	0	16	0	16	32
X	11330935	103	0	0	0	103
X	11371626	0	0	0	0	0
X	11553315	91	0	0	0	91
X	11575555	12	0	6	0	18
X	11704179	150	0	45	0	195
X	11704188	125	0	65	0	190
X	11812074	0	48	0	81	129
X	11812089	0	64	0	69	133
X	11939698	0	33	0	35	68
X	11939764	0	19	0	45	64
X	11949882	0	41	0	32	73
X	11949883	0	18	0	53	71
X	11954277	0	54	0	18	72
X	11955525	0	2	0	3	5
X	11955561	0	5	0	6	11
X	11964192	0	4	0	42	46
X	11967712	0	11	0	8	19
X	11968032	0	5	0	9	14
X	11968676	0	2	0	57	59
X	11968768	0	31	0	16	47
X	11968969	0	13	0	50	63
X	11970546	0	12	0	38	50
X	11970552	0	4	0	41	45
X	11970556	0	19	0	32	51
X	11971853	0	34	0	18	52
X	11977538	0	35	0	8	43
X	12178407	0	0	0	0	0
X	12234654	0	0	0	0	0
X	12321994	0	0	114	0	114
X	12411368	0	0	0	0	0
X	12446818	28	0	4	0	32
X	12517682	0	13	0	39	52
X	12517716	0	10	0	43	53
X	12530707	0	0	0	0	0
X	12570094	0	8	0	8	16
X	12570147	0	12	0	3	15
X	12610058	0	1	0	64	65
X	12633103	2	0	6	0	8
X	12638680	405	0	45	0	450
X	12670776	0	0	0	0	0
X	12772709	15	0	23	0	38
X	12779207	0	4	0	2	6
X	12836423	0	0	0	0	0
X	12920895	6	0	0	0	6
X	13075382	32	0	75	0	107
X	13326657	0	0	52	0	52
X	13338794	36	0	0	0	36
X	13363027	0	0	0	0	0
X	13363147	0	0	3	0	3
X	13364994	18	0	22	0	40
X	13375332	0	0	1	0	1
X	13713539	36	0	3	0	39
X	13713540	35	0	5	0	40
X	13713557	37	0	2	0	39
X	13713560	37	0	1	0	38
X	13713989	24	0	4	0	28
X	13714028	37	0	0	0	37
X	13714030	37	0	1	0	38
X	13714099	31	0	1	0	32
X	13714108	27	0	4	0	31
X	13915030	0	0	0	0	0
X	13960364	0	0	0	0	0
X	13981405	0	0	0	1	1
X	13988603	0	2	0	3	5
X	14017285	0	0	0	0	0
X	14272086	86	0	31	0	117
X	14272092	6	0	109	0	115
X	14272096	3	0	114	0	117
X	14274268	99	0	34	0	133
X	14791453	0	44	0	131	175
X	14803625	0	0	0	0	0
X	14827027	0	12	0	59	71
X	14827028	0	26	0	44	70
X	14827029	0	26	0	43	69
X	14904567	1399	0	1	0	1400
X	14932507	47	0	14	0	61
X	14996674	20	0	30	0	50
X	14999166	2	0	4	0	6
X	14999641	7	0	8	0	15
X	14999868	7	0	52	0	59
X	14999920	58	0	5	0	63
X	14999924	8	0	57	0	65
X	14999938	51	0	5	0	56
X	15000623	20	0	44	0	64
X	15002265	19	0	12	0	31
X	15004413	16	0	45	0	61
X	15004776	10	0	48	0	58
X	15004857	22	0	60	0	82
X	15004878	48	0	26	0	74
X	15043300	0	0	0	0	0
X	15058391	0	27	0	22	49
X	15098493	94	0	71	0	165
X	15098592	80	0	91	0	171
X	15111879	48	0	93	0	141
X	15112038	70	0	1	0	71
X	15304670	0	0	0	0	0
X	15388627	0	15	0	42	57
X	15392685	0	108	0	20	128
X	15483634	35	0	0	0	35
X	15484167	31	0	0	0	31
X	15501741	0	0	0	0	0
X	15531613	0	0	0	1	1
X	15581889	0	28	0	0	28
X	15897294	427	1	325	0	753
X	15897759	36	0	20	0	56
X	15897789	52	0	2	0	54
X	15897854	41	0	11	0	52
X	15897856	50	0	1	0	51
X	15903965	10	3	158	0	171
X	15919889	124	0	8	0	132
X	15952334	0	6	0	7	13
X	15956689	0	2	0	25	27
X	15956841	0	3	1	26	30
X	15958587	0	125	0	11	136
X	15961105	0	0	0	10	10
X	15961636	0	6	0	10	16
X	15989371	0	3	0	47	50
X	16075853	0	1	0	42	43
X	16339624	65	0	57	0	122
X	16339799	64	0	11	0	75
X	16456420	0	1	0	20	21
X	16456425	0	9	0	10	19
X	16460238	0	7	0	33	40
X	16460589	0	4	0	36	40
X	16460590	0	2	0	38	40
X	16460595	0	4	0	37	41
X	16464719	0	61	0	8	69
X	16466198	0	5	0	8	13
X	16466199	0	9	0	4	13
X	16466203	0	2	0	11	13
X	16466204	0	2	0	11	13
X	16466216	0	2	0	11	13
X	16466692	0	0	0	47	47
X	16468562	0	53	0	3	56
X	16469630	0	13	0	17	30
X	16469631	0	16	0	12	28
X	16471229	0	17	0	21	38
X	16471265	0	20	0	24	44
X	16471290	0	6	0	31	37
X	16471319	0	16	0	16	32
X	16471811	0	6	0	7	13
X	16471812	0	5	0	9	14
X	16471813	0	8	0	5	13
X	16471814	0	6	0	7	13
X	16473609	0	1	0	24	25
X	16473610	0	1	0	23	24
X	16473637	0	10	0	10	20
X	16473638	0	1	0	19	20
X	16475638	0	10	0	34	44
X	16475685	0	3	0	40	43
X	16477558	0	6	0	34	40
X	16481881	0	3	0	23	26
X	16482682	0	24	0	20	44
X	16482683	0	14	0	31	45
X	16482692	0	1	0	42	43
X	16482693	0	23	0	20	43
X	16504240	0	19	0	18	37
X	16504273	0	0	0	50	50
X	16505310	0	2	0	9	11
X	16505550	0	58	0	10	68
X	16509658	0	8	0	50	58
X	16509671	0	4	0	54	58
X	16509684	0	12	0	50	62
X	16511854	0	3	0	11	14
X	16514487	0	1	0	8	9
X	16517164	0	10	0	6	16
X	16518833	0	37	0	17	54
X	16523520	0	0	0	1	1
X	16523529	0	0	0	1	1
X	16523541	0	0	0	1	1
X	16523553	0	0	0	0	0
X	16523556	0	0	0	0	0
X	16523557	0	0	0	0	0
X	16532860	0	0	0	0	0
X	16532866	0	0	0	0	0
X	16562027	0	8	0	62	70
X	16562108	0	17	0	53	70
X	16681534	0	2	0	33	35
X	16839820	0	22	0	50	72
X	16839947	0	6	0	71	77
X	16905030	0	0	0	0	0
X	16915290	8	0	0	0	8
X	17016883	0	1	0	2	3
X	17016898	0	0	0	4	4
X	17017015	0	2	0	1	3
X	17027613	0	0	0	0	0
X	17082644	0	0	0	0	0
X	17097065	64	0	0	0	64
X	17291667	0	0	0	1	1
X	17666685	618	0	0	0	618
X	17674476	0	3	0	5	8
X	17926624	0	23	0	16	39
X	17930651	0	38	0	22	60
X	17930658	0	49	0	11	60
X	17930733	0	36	0	34	70
X	17930890	0	31	0	2	33
X	17930948	0	14	0	11	25
X	17936502	0	1	0	15	16
X	17938011	0	0	0	90	90
X	17941537	0	4	0	9	13
X	17941569	0	0	0	14	14
X	17941570	0	0	0	14	14
X	17942236	0	0	0	21	21
X	17945833	0	2	0	19	21
X	17950057	0	28	0	102	130
X	17952716	0	7	0	105	112
X	17952717	1	8	0	100	109
X	17961411	0	1	0	0	1
X	17981650	0	8	0	13	21
X	17982144	0	17	0	2	19
X	17983811	0	10	0	11	21
X	17983847	0	18	0	2	20
X	17987714	0	1	0	7	8
X	17987788	0	3	0	14	17
X	17987790	0	8	0	9	17
X	17987796	0	8	0	9	17
X	17988376	0	0	0	7	7
X	17989432	0	1	0	15	16
X	17989433	0	12	0	4	16
X	17991679	0	0	0	0	0
X	17991684	0	0	0	0	0
X	17991689	0	0	0	0	0
X	17991690	0	0	0	0	0
X	17991691	0	0	0	0	0
X	18107572	0	0	0	15	15
X	18107970	0	0	0	13	13
X	18170126	12	0	20	0	32
X	18172085	80	0	0	0	80
X	18172108	56	0	0	0	56
X	18173979	37	0	3	0	40
X	18174020	33	0	5	0	38
X	18174056	40	0	6	0	46
X	18177807	7	0	0	0	7
X	18201429	79	0	9	0	88
X	18558815	4	0	0	0	4
X	18901523	4	0	1	0	5
X	19153046	1	0	0	63	64
X	19265115	9	0	17	0	26
X	19265410	1	0	4	0	5
X	19283881	0	22	0	81	103
X	19334465	0	70	0	8	78
X	19334522	0	11	0	62	73
X	19341081	0	2	0	32	34
X	19341084	0	2	0	30	32
X	19341882	0	2	0	78	80
X	19342007	0	38	0	38	76
X	19508447	348	0	53	0	401
X	19545747	0	0	0	1	1
X	19641588	0	48	0	69	117
X	19651650	0	0	0	22	22
X	19727697	10	0	172	0	182
X	19727698	15	0	167	0	182
X	19831888	0	1	0	20	21
X	19835017	0	12	0	18	30
X	19857622	28	0	0	0	28
X	19888186	1	0	0	0	1
X	20330037	0	0	0	0	0
X	20330041	0	0	0	0	0
X	20770084	0	8	0	1	9
X	20773442	0	7	0	3	10
X	20819626	0	0	0	0	0
X	20828303	0	0	0	3	3
X	20828316	0	1	0	2	3
X	20828348	0	1	0	2	3
X	20828364	0	3	0	1	4
X	20828369	0	3	0	1	4
X	20828370	0	2	0	2	4
X	20923843	0	5	0	10	15
X	20924823	0	1	0	2	3
X	21068672	0	0	0	0	0
X	21304740	0	0	0	0	0
X	21629428	0	124	0	209	333
X	21629453	0	115	0	226	341
X	21629508	0	49	0	281	330
X	21629725	0	186	0	144	330
X	21629726	0	139	0	182	321
X	21629727	0	133	0	197	330
X	21629737	0	183	0	146	329
X	22489005	5	0	2	0	7
X	22489022	8	0	0	0	8
X	22499716	63	0	10	0	73
X	22499717	43	0	30	0	73
X	22499732	28	0	45	0	73
X	22502642	247	0	40	2	289
X	22502713	71	0	200	0	271
X	22502735	212	0	71	0	283
X	22980987	1	17	0	236	254
X	22982709	0	436	0	228	664
X	22983936	0	22	0	6	28
X	22984239	0	11	0	25	36
X	22984267	0	4	0	40	44
X	22984352	0	6	0	38	44
X	23024266	1	0	4	0	5
X	23029207	1	0	1	0	2
X	23206974	0	0	0	0	0
Y	400261	0	0	0	0	0
Y	688072	0	0	0	0	0
Y_CP007107v1_random	40134	0	0	0	0	0
Y_DS485767v1_random	101	0	0	0	0	0
