#CHR	POS	Count_A	Count_C	Count_G	Count_T	Good_depth
2R	669894	0	0	0	0	0
2R	927745	0	29	0	41	70
2R	927747	0	14	0	54	68
2R	927763	0	20	0	50	70
2R	927764	0	41	0	30	71
2R	927773	0	32	0	37	69
2R	928819	0	127	0	40	167
2R	928861	0	8	0	155	163
2R	928866	0	94	0	59	153
2R	928867	0	24	0	134	158
2R	946817	0	2	0	16	18
2R	947223	0	1	0	3	4
2R	948265	0	1	0	4	5
2R	949521	0	8	0	2	10
2R	1268441	4	0	6	0	10
2R	1271549	1	0	0	0	1
2R	1362581	0	0	0	0	0
2R	1397455	0	0	0	0	0
2R	1424437	1	0	0	0	1
2R	1424453	1	0	0	0	1
2R	1591958	21	0	1	0	22
2R	1593302	32	0	1	0	33
2R	1593303	28	0	4	0	32
2R	1593310	29	0	5	0	34
2R	1593315	31	0	3	0	34
2R	1593825	13	0	4	0	17
2R	1594032	28	0	1	0	29
2R	1595342	6	0	2	0	8
2R	1595440	18	0	1	0	19
2R	1607075	0	0	0	0	0
2R	1728919	0	0	0	0	0
2R	1738108	0	0	1	0	1
2R	1865062	0	2	0	7	9
2R	1865075	0	3	0	4	7
2R	1865085	0	3	0	4	7
2R	1865087	0	2	0	5	7
2R	1865348	0	0	0	8	8
2R	1865369	0	2	0	5	7
2R	1865574	0	4	0	1	5
2R	1873696	0	0	0	1	1
2R	1891695	0	0	0	0	0
2R	1893555	0	0	0	0	0
2R	1895974	0	0	0	0	0
2R	1905603	0	0	0	0	0
2R	1916341	0	0	0	0	0
2R	1917254	0	0	0	0	0
2R	1958846	0	0	0	0	0
2R	1986061	0	0	0	0	0
2R	1994663	0	0	0	2	2
2R	1994676	0	0	0	2	2
2R	2080600	0	1	0	0	1
2R	2108301	0	1	0	0	1
2R	2191810	0	0	0	0	0
2R	2194077	0	0	0	0	0
2R	2195782	0	0	0	0	0
2R	2202217	0	0	0	1	1
2R	2202225	0	0	0	1	1
2R	2241894	0	0	0	1	1
2R	2246575	0	0	0	0	0
2R	2246585	0	0	0	0	0
2R	2246586	0	0	0	0	0
2R	2246597	0	0	0	0	0
2R	2246605	0	0	0	0	0
2R	2246607	0	0	0	0	0
2R	2246610	0	0	0	0	0
2R	2246614	0	0	0	0	0
2R	2246619	0	0	0	0	0
2R	2246626	0	0	0	0	0
2R	2246628	0	0	0	0	0
2R	2246630	0	0	0	0	0
2R	2246649	0	0	0	0	0
2R	2246650	0	0	0	0	0
2R	2246657	0	0	0	0	0
2R	2246661	0	0	0	0	0
2R	2246666	0	0	0	0	0
2R	2246668	0	0	0	0	0
2R	2246670	0	0	0	0	0
2R	2246672	0	0	0	0	0
2R	2246674	0	0	0	0	0
2R	2246677	0	0	0	0	0
2R	2246691	0	0	0	0	0
2R	2246694	0	0	0	0	0
2R	2246705	0	0	0	0	0
2R	2246718	0	0	0	0	0
2R	2246721	0	0	0	0	0
2R	2246725	0	0	0	0	0
2R	2246749	0	0	0	0	0
2R	2246751	0	0	0	0	0
2R	2246758	0	0	0	0	0
2R	2247749	0	0	0	0	0
2R	2256918	0	0	0	1	1
2R	2257284	0	0	0	0	0
2R	2257289	0	0	0	0	0
2R	2257295	0	0	0	0	0
2R	2257742	0	0	0	3	3
2R	2257793	0	0	0	3	3
2R	2257825	0	0	0	2	2
2R	2257846	0	0	0	3	3
2R	2260195	0	0	0	5	5
2R	2260208	0	0	0	5	5
2R	2260246	0	0	0	6	6
2R	2260647	0	0	0	1	1
2R	2487897	0	0	0	0	0
2R	2487913	0	0	0	0	0
2R	2495761	0	2	0	39	41
2R	2496768	0	20	0	35	55
2R	2496780	0	37	0	16	53
2R	2498338	0	3	0	15	18
2R	2498339	0	1	0	17	18
2R	2498347	0	13	0	4	17
2R	2498348	0	2	0	16	18
2R	2498350	0	3	0	17	20
2R	2498351	0	6	0	14	20
2R	2498353	0	6	0	12	18
2R	2498356	0	13	0	5	18
2R	2498359	0	5	0	11	16
2R	2498363	0	5	0	11	16
2R	2498364	0	6	0	10	16
2R	2517609	0	6	0	17	23
2R	2519999	0	3	0	9	12
2R	2554231	0	0	0	3	3
2R	2554519	0	0	0	2	2
2R	2554530	0	0	0	3	3
2R	2562370	0	2	0	1	3
2R	2562467	0	3	0	4	7
2R	2563510	0	1	0	4	5
2R	2640746	0	0	0	0	0
2R	2820914	0	0	0	1	1
2R	2821043	0	0	0	2	2
2R	2822225	0	0	0	0	0
2R	2822367	0	0	0	0	0
2R	2822866	0	0	0	0	0
2R	2822867	0	0	0	0	0
2R	2822874	0	0	0	0	0
2R	2822875	0	0	0	0	0
2R	2822877	0	0	0	0	0
2R	2822880	0	0	0	0	0
2R	2822883	0	0	0	0	0
2R	2822884	0	0	0	0	0
2R	2822887	0	0	0	0	0
2R	2822888	0	0	0	0	0
2R	2822893	0	0	0	0	0
2R	2822941	0	0	0	0	0
2R	2822942	0	0	0	0	0
2R	2822956	0	0	0	0	0
2R	2822957	0	0	0	0	0
2R	2822958	0	0	0	0	0
2R	2822961	0	0	0	0	0
2R	2822991	0	0	0	0	0
2R	2822995	0	0	0	0	0
2R	2822996	0	0	0	0	0
2R	2822997	0	0	0	0	0
2R	2823003	0	0	0	0	0
2R	2823005	0	0	0	0	0
2R	2823006	0	0	0	0	0
2R	2823007	0	0	0	0	0
2R	2823097	0	0	0	2	2
2R	2823428	0	0	0	1	1
2R	2823645	0	1	0	2	3
2R	2823852	0	0	0	0	0
2R	2831098	0	0	0	0	0
2R	2831110	0	0	0	0	0
2R	2832245	0	0	0	1	1
2R	2843105	0	1	0	2	3
2R	2843112	0	2	0	1	3
2R	2843113	0	2	0	1	3
2R	2843121	0	3	0	0	3
2R	2843122	0	1	0	2	3
2R	2843124	0	1	0	1	2
2R	2843130	0	2	0	1	3
2R	2846308	0	0	0	5	5
2R	2954347	0	0	0	0	0
2R	2954369	0	0	0	0	0
2R	2954754	0	0	0	0	0
2R	2970910	0	0	0	0	0
2R	3104182	0	0	0	0	0
2R	3190285	12	0	3	0	15
2R	3919432	0	5	0	0	5
2R	3932880	0	0	0	2	2
2R	3941840	0	3	0	4	7
2R	4052078	1	0	0	0	1
2R	4052143	1	0	0	0	1
2R	4052192	0	0	0	0	0
2R	4052205	0	0	0	0	0
2R	4052208	0	0	0	0	0
2R	4052224	0	0	0	0	0
2R	4052238	0	0	0	0	0
2R	4052252	0	0	0	0	0
2R	4052268	0	0	0	0	0
2R	4052279	0	0	0	0	0
2R	4220796	0	0	0	0	0
2R	4350268	0	0	0	0	0
2R	4350386	0	0	0	0	0
2R	4367099	0	0	0	0	0
2R	4397570	0	0	0	0	0
2R	4397571	0	0	0	0	0
2R	4397577	0	0	0	0	0
2R	4397580	0	0	0	0	0
2R	4397583	0	0	0	0	0
2R	4397588	0	0	0	0	0
2R	4397601	0	0	0	0	0
2R	4397632	0	0	0	0	0
2R	4397638	0	0	0	0	0
2R	4397643	0	0	0	0	0
2R	4397645	0	0	0	0	0
2R	4397646	0	0	0	0	0
2R	4397658	0	0	0	0	0
2R	4407456	0	0	0	0	0
2R	4407479	0	0	0	0	0
2R	4470411	0	0	0	0	0
2R	4598137	4	0	4	0	8
2R	4610290	0	0	0	0	0
2R	4610327	0	0	1	0	1
2R	4610328	0	0	1	0	1
2R	4610335	0	0	1	0	1
2R	4610338	1	0	0	0	1
2R	4610340	0	0	1	0	1
2R	4610343	1	0	0	0	1
2R	4610344	0	0	1	0	1
2R	4749085	16	0	0	0	16
2R	4787711	0	20	0	83	103
2R	4790435	1	0	0	0	1
2R	4795353	0	0	0	0	0
2R	5027097	0	0	0	0	0
2R	5068277	0	3	0	4	7
2R	5069358	0	0	0	4	4
2R	5069359	0	0	0	3	3
2R	5069360	0	0	0	4	4
2R	5119406	0	7	0	24	31
2R	5120152	0	4	0	8	12
2R	5124254	0	1	0	0	1
2R	5127276	0	1	0	4	5
2R	5211451	0	0	0	0	0
2R	5302757	0	0	0	0	0
2R	5320850	7	0	2	0	9
2R	5337012	0	0	0	0	0
2R	5495400	0	0	0	5	5
2R	5503750	0	0	0	0	0
2R	5503767	0	0	0	0	0
2R	5503911	0	0	0	0	0
2R	5503915	0	0	0	0	0
2R	5504022	0	0	0	0	0
2R	5504026	0	0	0	0	0
2R	5504425	0	0	0	0	0
2R	5504526	0	0	0	0	0
2R	5505677	0	0	0	0	0
2R	5505735	0	0	0	0	0
2R	5505798	0	0	0	0	0
2R	5505800	0	0	0	0	0
2R	5505852	0	0	0	0	0
2R	6031677	0	0	0	1	1
2R	6039689	0	18	0	13	31
2R	6174962	426	0	0	0	426
2R	6571523	0	0	0	0	0
2R	6725344	0	1	0	44	45
2R	6733080	0	2	0	42	44
2R	6733220	0	1	0	51	52
2R	6817728	7	0	4	0	11
2R	6927455	0	4	0	19	23
2R	7130316	0	0	0	5	5
2R	7401894	0	0	0	1	1
2R	7501178	13	0	56	0	69
2R	7502188	15	0	26	0	41
2R	7502199	15	0	22	0	37
2R	7664923	13	0	0	0	13
2R	7813863	55	1	76	0	132
2R	8100701	30	0	19	0	49
2R	8144501	0	2	0	1	3
2R	8464487	139	0	1	0	140
2R	8482655	0	0	0	41	41
2R	8511471	0	0	0	1	1
2R	8616059	148	0	0	0	148
2R	8618670	284	0	0	0	284
2R	8696454	7	0	0	0	7
2R	8876533	59	0	7	0	66
2R	8876790	76	0	11	0	87
2R	8877577	93	0	11	0	104
2R	8883706	4	0	108	0	112
2R	8883745	62	0	44	0	106
2R	8885231	66	0	18	0	84
2R	8885377	78	0	30	0	108
2R	8903673	1380	0	97	0	1477
2R	8903674	1271	0	118	0	1389
2R	8903680	1207	0	293	0	1500
2R	8912445	0	0	0	2	2
2R	9100226	9	0	0	0	9
2R	9110821	4	0	0	0	4
2R	9119427	32	0	0	0	32
2R	9120392	9	0	64	0	73
2R	9158865	0	0	0	23	23
2R	9168104	0	0	0	51	51
2R	9171291	0	0	0	27	27
2R	9171360	0	0	0	30	30
2R	9191664	0	0	0	178	178
2R	9229669	0	30	0	179	209
2R	9229804	0	149	1	402	552
2R	9229936	0	206	0	301	507
2R	9232371	0	0	0	20	20
2R	9234514	0	273	0	186	459
2R	9234519	0	312	1	132	445
2R	9311068	0	9	0	132	141
2R	9312080	0	44	0	56	100
2R	9312087	0	31	0	69	100
2R	9312091	0	1	0	97	98
2R	9312092	96	0	0	0	96
2R	9312093	0	7	0	91	98
2R	9312094	1	6	0	89	96
2R	9328201	0	2	0	3	5
2R	9344191	0	1	0	1	2
2R	9344213	0	3	0	0	3
2R	9345714	0	3	0	4	7
2R	9369253	0	0	0	1	1
2R	9408179	0	0	0	0	0
2R	9440747	0	51	0	15	66
2R	9534930	192	1	107	1	301
2R	9534943	295	0	29	0	324
2R	9539059	0	203	0	50	253
2R	9542736	0	3	0	4	7
2R	9542851	0	0	0	4	4
2R	9592745	0	0	0	0	0
2R	9598728	10	0	0	0	10
2R	9599645	1	0	1	0	2
2R	9619360	0	0	0	1	1
2R	9633098	0	0	0	0	0
2R	9721527	0	1	0	6	7
2R	9723564	0	0	0	33	33
2R	9739197	0	0	0	0	0
2R	9753896	887	0	21	0	908
2R	9817692	0	0	0	25	25
2R	9819309	0	4	0	20	24
2R	9819328	0	6	0	20	26
2R	9819477	0	1	0	13	14
2R	9819490	0	3	0	11	14
2R	9884160	0	21	0	156	177
2R	9927725	0	0	0	0	0
2R	10011276	0	1	0	0	1
2R	10091619	11	0	0	0	11
2R	10108800	849	0	413	1	1263
2R	10108801	894	0	354	0	1248
2R	10108802	992	0	249	0	1241
2R	10222721	0	2	0	4	6
2R	10278408	15	0	0	0	15
2R	10279089	32	0	0	0	32
2R	10280883	36	0	40	0	76
2R	10280988	29	0	57	0	86
2R	10285619	107	0	0	0	107
2R	10321544	17	0	0	0	17
2R	10327175	0	10	0	7	17
2R	10330783	0	0	0	7	7
2R	10330787	0	2	0	6	8
2R	10330795	0	1	0	5	6
2R	10330796	0	0	0	7	7
2R	10330801	0	2	0	3	5
2R	10330802	0	3	0	3	6
2R	10336774	0	13	0	63	76
2R	10378403	0	0	0	1	1
2R	10378432	0	0	0	1	1
2R	10378433	0	0	0	1	1
2R	10392192	0	0	0	16	16
2R	10393990	0	0	0	8	8
2R	10472135	0	41	0	197	238
2R	10531606	0	1	0	4	5
2R	10540485	0	0	0	1	1
2R	10611461	181	0	11	0	192
2R	10611464	170	0	26	1	197
2R	10706747	25	0	1	0	26
2R	10783584	0	1	0	1	2
2R	10785766	0	4	0	0	4
2R	10785846	0	0	0	6	6
2R	10788717	1	0	0	0	1
2R	10789955	1	0	0	0	1
2R	10815342	55	0	0	0	55
2R	10837913	0	492	0	0	492
2R	10840470	0	128	0	32	160
2R	10855471	0	0	0	2	2
2R	11148789	0	0	0	37	37
2R	11229833	0	0	0	173	173
2R	11293045	0	14	0	52	66
2R	11447601	70	0	363	0	433
2R	11447607	13	0	442	0	455
2R	11447617	71	0	361	0	432
2R	11447623	102	0	343	0	445
2R	11447933	478	0	0	0	478
2R	11447935	442	0	37	0	479
2R	11447987	330	0	196	0	526
2R	11450317	214	0	270	0	484
2R	11450318	249	0	231	1	481
2R	11603464	0	1	0	1	2
2R	11635584	0	1	0	0	1
2R	11635585	0	1	0	1	2
2R	11635587	0	1	0	1	2
2R	11635588	0	1	0	0	1
2R	11671280	0	0	0	1	1
2R	11779856	0	0	0	0	0
2R	11827392	0	0	0	11	11
2R	11845525	42	0	11	0	53
2R	11893047	11	0	1	0	12
2R	11990709	25	0	10	0	35
2R	12024356	0	6	0	5	11
2R	12025551	0	10	0	8	18
2R	12025588	0	9	0	0	9
2R	12265428	18	0	0	0	18
2R	12269039	17	0	1	0	18
2R	12328060	34	0	0	0	34
2R	12328068	34	0	0	0	34
2R	12328073	34	0	0	0	34
2R	12329738	0	0	0	0	0
2R	12350262	0	0	0	0	0
2R	12448654	107	0	38	0	145
2R	12448686	93	0	72	0	165
2R	12448723	145	0	49	1	195
2R	12448779	99	0	100	0	199
2R	12469039	7	0	0	0	7
2R	12470834	11	0	0	0	11
2R	12489327	0	0	0	91	91
2R	12648195	0	0	0	4	4
2R	12754897	0	2	0	0	2
2R	12758582	65	0	105	0	170
2R	12800608	5	0	23	0	28
2R	12800859	38	0	7	0	45
2R	12921246	193	0	142	0	335
2R	12921325	225	0	170	0	395
2R	12921326	303	0	90	0	393
2R	13437401	0	0	0	16	16
2R	13517261	1	15	0	147	163
2R	13517274	0	65	0	89	154
2R	13517275	0	118	0	38	156
2R	13517347	0	30	0	101	131
2R	13580366	4	0	0	0	4
2R	13747628	13	0	29	0	42
2R	13748897	0	0	35	0	35
2R	13809071	39	0	10	0	49
2R	13809547	27	0	123	0	150
2R	13809607	90	0	54	0	144
2R	13809962	124	0	76	0	200
2R	13810199	106	0	58	0	164
2R	13817109	170	1	69	0	240
2R	13817124	186	0	19	0	205
2R	13817379	43	0	199	0	242
2R	13823895	0	0	0	81	81
2R	13846257	2	0	0	0	2
2R	13858942	0	0	0	0	0
2R	13885952	0	0	0	99	99
2R	13886458	0	19	0	46	65
2R	13887556	0	47	0	39	86
2R	13893580	0	20	0	62	82
2R	13893934	0	42	0	24	66
2R	13916837	0	0	0	0	0
2R	13974052	0	0	0	59	59
2R	14062507	0	10	0	94	104
2R	14062651	0	45	0	54	99
2R	14062768	0	42	0	85	127
2R	14062771	1	67	0	62	130
2R	14062774	0	17	0	114	131
2R	14149035	0	0	0	69	69
2R	14152423	0	10	0	0	10
2R	14153104	0	3	0	0	3
2R	14171351	22	0	0	0	22
2R	14172781	194	0	45	0	239
2R	14178731	195	0	43	0	238
2R	14182106	59	0	18	0	77
2R	14215739	0	0	0	1	1
2R	14297994	298	0	110	0	408
2R	14331618	1	0	0	0	1
2R	14334547	0	0	0	0	0
2R	14355520	21	0	8	0	29
2R	14361978	6	4	0	0	10
2R	14507629	44	0	0	0	44
2R	14538499	0	0	0	0	0
2R	14555183	0	0	0	0	0
2R	14740426	0	10	0	247	257
2R	14741592	0	166	0	106	272
2R	14742174	0	27	0	411	438
2R	14742210	0	139	0	287	426
2R	14742223	0	97	0	309	406
2R	14742241	0	154	0	268	422
2R	14742359	0	0	1	372	373
2R	14756598	266	0	0	0	266
2R	14762018	0	120	0	149	269
2R	14971913	0	0	102	0	102
2R	15264046	0	50	0	41	91
2R	15264051	0	38	0	47	85
2R	15264096	0	73	0	22	95
2R	15264743	0	21	0	44	65
2R	15415679	37	1	1	0	39
2R	15456269	8	0	4	0	12
2R	15460575	19	0	4	0	23
2R	15460578	19	0	3	0	22
2R	15516140	0	2	0	58	60
2R	15518712	0	56	0	73	129
2R	15765728	0	0	0	36	36
2R	15766457	0	0	0	28	28
2R	15772754	0	0	0	1	1
2R	15772755	0	0	0	1	1
2R	15775053	0	5	0	25	30
2R	15777061	0	7	0	2	9
2R	15779915	0	1	0	0	1
2R	15779918	0	1	0	0	1
2R	15779987	0	1	0	0	1
2R	15779998	0	0	0	1	1
2R	15786556	0	0	0	0	0
2R	15809225	0	0	0	3	3
2R	15871835	0	75	0	31	106
2R	15872366	0	105	0	23	128
2R	15980167	0	0	0	15	15
2R	16336488	9	0	1	0	10
2R	16432544	12	0	0	0	12
2R	16534056	0	0	0	0	0
2R	16576409	0	233	0	0	233
2R	16647491	58	0	18	0	76
2R	16647492	17	0	58	0	75
2R	16647565	63	0	12	0	75
2R	16647597	71	0	11	0	82
2R	16647631	16	0	65	0	81
2R	16650664	58	0	1	0	59
2R	16650669	60	0	0	0	60
2R	16650728	62	0	0	0	62
2R	16650742	66	0	2	0	68
2R	16650776	45	0	20	0	65
2R	16650779	58	0	5	0	63
2R	16650790	38	0	29	0	67
2R	16650805	49	0	16	0	65
2R	16650890	51	0	6	0	57
2R	16762451	0	0	0	2	2
2R	16765101	0	0	0	16	16
2R	16917584	0	0	0	0	0
2R	16932924	21	0	0	0	21
2R	17222715	0	0	0	0	0
2R	17364649	6	0	7	0	13
2R	17374869	38	0	62	0	100
2R	17375028	81	0	37	0	118
2R	17375029	90	0	24	0	114
2R	17375057	40	0	75	0	115
2R	17375058	58	0	57	0	115
2R	17377109	32	0	144	0	176
2R	17377110	39	0	130	0	169
2R	17377122	58	0	116	0	174
2R	17377125	96	0	66	0	162
2R	17377403	77	0	64	0	141
2R	17701194	0	0	0	0	0
2R	18020907	0	0	0	0	0
2R	18134284	0	0	0	10	10
2R	18145289	7	0	0	0	7
2R	18167781	127	0	0	0	127
2R	18173890	33	0	0	0	33
2R	18281192	0	0	0	95	95
2R	18356868	0	7	0	12	19
2R	18518047	8	0	2	0	10
2R	18518048	8	0	2	0	10
2R	18720854	0	0	0	0	0
2R	18743376	0	0	0	0	0
2R	18865057	0	0	0	0	0
2R	18998450	14	0	1	0	15
2R	19006082	65	0	54	0	119
2R	19006586	0	0	0	0	0
2R	19138221	0	0	0	0	0
2R	19139754	98	0	0	0	98
2R	19179174	17	0	3	0	20
2R	19223379	48	0	17	0	65
2R	19223636	44	0	71	0	115
2R	19225658	108	0	60	0	168
2R	19303685	61	0	9	0	70
2R	19326309	0	29	0	33	62
2R	19525936	0	0	0	37	37
2R	19566903	0	4	0	24	28
2R	19625834	0	0	0	0	0
2R	19727230	0	0	0	0	0
2R	20424540	69	0	0	0	69
2R	20658504	0	0	9	0	9
2R	21145178	450	0	44	0	494
2R	21315686	69	0	50	0	119
2R	21334960	10	0	15	0	25
2R	21480214	0	14	0	62	76
2R	21557174	12	0	54	0	66
2R	21620849	0	30	0	40	70
2R	21621075	0	34	0	30	64
2R	21653466	60	1	89	0	150
2R	21851363	0	0	0	0	0
2R	22175545	31	0	0	0	31
2R	22227209	0	0	0	30	30
2R	22391510	32	0	82	0	114
2R	22564373	0	38	0	68	106
2R	22564377	0	37	0	64	101
2R	22568445	0	0	0	0	0
2R	22573070	0	1	0	0	1
2R	22587796	0	0	0	0	0
2R	22637905	54	0	0	0	54
2R	22673075	16	0	0	0	16
2R	22746263	0	9	0	10	19
2R	23381950	0	0	0	41	41
2R	23598132	17	0	1	0	18
2R	23804970	0	0	0	0	0
2R	23838782	36	0	4	0	40
2R	23844274	0	0	0	68	68
2R	23867196	0	0	0	257	257
2R	24006102	0	0	0	56	56
2R	24006115	0	0	0	58	58
2R	24006555	0	73	0	11	84
2R	24046125	0	0	0	0	0
2R	24050977	36	0	26	0	62
2R	24051555	63	0	10	0	73
2R	24218949	0	0	0	0	0
2R	24332337	0	0	0	2	2
2R	24384812	0	68	0	11	79
2R	24419247	0	177	0	26	203
2R	24419250	0	181	0	28	209
2R	24500965	0	0	0	2	2
2R	24512318	0	29	0	75	104
2R	24882682	84	0	18	0	102
2R	24882751	81	0	50	0	131
2R	24885850	99	0	23	0	122
2R	24904717	174	0	21	0	195
2R	24910398	186	0	130	0	316
2R	24910568	157	0	82	0	239
2R	24910752	153	0	31	0	184
2R	24910775	30	0	164	0	194
2R	24910814	123	0	119	0	242
2R	24910823	102	0	149	0	251
2R	24911061	84	0	124	0	208
2R	24911109	81	0	127	0	208
2R	24912004	115	0	36	0	151
2R	24912848	54	0	192	0	246
2R	24912923	250	0	0	0	250
2R	24914689	180	0	37	0	217
2R	24914702	56	0	155	0	211
2R	24914794	53	0	135	0	188
2R	24914829	166	0	19	0	185
2R	24914858	10	0	212	0	222
2R	24914859	207	0	15	0	222
2R	24914864	63	0	164	0	227
2R	24914865	86	0	146	0	232
2R	24914874	115	0	124	0	239
2R	24919093	230	0	46	0	276
2R	24920153	132	0	3	0	135
2R	24995597	0	32	0	73	105
2R	24995857	0	58	0	61	119
2R	25255069	57	0	3	0	60
2R	25255079	30	0	31	0	61
2R	25255082	26	0	37	0	63
2R	25255913	70	0	10	0	80
2R	25256658	24	0	28	0	52
2R	25257110	42	0	5	0	47
2R	25257267	30	0	46	0	76
2R	25257297	54	0	24	0	78
2R	25257312	22	0	46	0	68
2R	25257313	11	0	59	0	70
2R	25257314	32	0	39	0	71
2R	25257317	40	0	31	0	71
2R	25257328	46	0	29	0	75
2R	25257336	60	0	8	0	68
2R	25257337	52	0	11	0	63
2R	25257342	6	0	66	0	72
2R	25257343	11	0	61	0	72
2R	25257375	73	0	2	0	75
2R	25257376	63	0	15	0	78
2R	25257377	39	0	37	0	76
2R	25257383	36	0	40	0	76
2R	25257388	46	0	29	0	75
2R	25257391	54	0	24	0	78
2R	25257392	62	0	17	0	79
2R	25257393	71	0	9	0	80
2R	25257394	44	0	37	0	81
2R	25257396	78	0	1	0	79
2R	25257397	66	0	15	0	81
2R	25257398	58	0	21	0	79
2R	25257404	32	0	46	0	78
2R	25257405	21	0	56	0	77
2R	25257406	33	0	46	0	79
2R	25257414	70	0	15	0	85
2R	25257417	34	0	54	0	88
2R	25257418	32	0	54	0	86
2R	25257420	71	0	13	0	84
2R	25257424	83	0	12	0	95
2R	25257425	18	0	76	1	95
2R	25257426	15	0	81	0	96
2R	25257427	74	0	24	0	98
2R	25257431	81	0	17	0	98
2R	25257439	88	0	13	0	101
2R	25257445	65	0	34	0	99
2R	25257451	30	0	70	0	100
2R	25257453	94	0	9	0	103
2R	25257483	74	0	34	0	108
2R	25257508	59	0	53	0	112
2R	25257625	66	0	9	0	75
2R	25257632	68	0	6	0	74
2R	25257633	70	0	2	0	72
2R	25257638	70	0	1	0	71
2R	25257643	47	0	23	0	70
2R	25257682	16	0	37	0	53
2R	25257683	22	0	29	0	51
2R	25257699	34	0	3	0	37
2R	25257701	23	0	16	0	39
2R	25257703	15	0	22	0	37
2R	25257714	19	0	19	0	38
2R	25257732	20	0	15	0	35
2R	25257735	25	0	15	0	40
2R	25257740	23	0	18	0	41
2R	25257741	32	0	9	0	41
2R	25257743	41	0	2	0	43
2R	25257781	26	0	17	0	43
2R	25257788	41	0	1	0	42
2R	25257789	39	0	1	0	40
2R	25257792	40	0	3	0	43
2R	25257806	10	0	24	0	34
2R	25257812	30	0	3	0	33
2R	25257820	24	0	7	0	31
2R	25257832	10	0	25	0	35
2R	25257836	12	0	21	0	33
2R	25257964	5	0	15	0	20
3L	71000	0	0	0	0	0
3L	214328	0	54	0	0	54
3L	226141	2629	0	161	0	2790
3L	271201	0	0	0	0	0
3L	336697	0	0	0	0	0
3L	346424	0	0	0	0	0
3L	346882	0	0	0	9	9
3L	411895	0	0	0	0	0
3L	462074	0	0	0	0	0
3L	498116	0	0	0	0	0
3L	546751	0	0	0	0	0
3L	575217	74	0	0	0	74
3L	598790	14	0	3	0	17
3L	991441	84	0	40	0	124
3L	1010857	0	0	0	0	0
3L	1011246	0	0	0	0	0
3L	1011285	0	0	0	0	0
3L	1026639	0	6	0	69	75
3L	1027109	0	44	0	98	142
3L	1033059	0	0	0	0	0
3L	1034384	0	5	0	2	7
3L	1034386	0	3	0	4	7
3L	1044064	0	0	0	0	0
3L	1046651	0	0	0	0	0
3L	1135014	0	0	0	0	0
3L	1138357	0	0	0	0	0
3L	1210848	1	0	0	0	1
3L	1217228	2	0	0	0	2
3L	1227904	1	0	0	0	1
3L	1230644	0	0	43	0	43
3L	1318745	0	1	0	0	1
3L	1407143	0	0	0	0	0
3L	1490348	0	1	0	5	6
3L	1526045	0	0	0	10	10
3L	1556299	0	0	0	180	180
3L	1689558	43	0	0	0	43
3L	1727806	0	0	0	0	0
3L	1782670	0	283	0	217	500
3L	1945203	0	0	0	4	4
3L	2001719	0	0	0	0	0
3L	2039782	0	3	0	51	54
3L	2039908	0	19	0	84	103
3L	2039918	0	37	0	74	111
3L	2039919	0	7	0	105	112
3L	2042849	0	0	0	115	115
3L	2043519	0	0	0	134	134
3L	2044551	0	0	0	109	109
3L	2044916	0	0	0	122	122
3L	2045959	0	0	0	112	112
3L	2051548	0	0	0	49	49
3L	2054348	0	0	0	9	9
3L	2055902	0	0	0	4	4
3L	2056964	0	0	0	4	4
3L	2060460	0	0	0	7	7
3L	2074107	0	0	0	23	23
3L	2080672	0	24	0	0	24
3L	2080891	0	21	0	0	21
3L	2089039	0	0	0	27	27
3L	2096769	0	99	0	0	99
3L	2125496	0	8	0	184	192
3L	2126093	0	36	0	188	224
3L	2134649	0	2	0	80	82
3L	2135049	0	0	1	123	124
3L	2190111	0	0	0	80	80
3L	2245947	0	0	0	0	0
3L	2251644	0	0	0	0	0
3L	2348350	0	0	0	0	0
3L	2372937	0	1	32	0	33
3L	2377732	0	0	0	3	3
3L	2390472	0	0	0	0	0
3L	2424958	0	0	0	0	0
3L	2440451	1	0	0	0	1
3L	2458238	8	1	0	0	9
3L	2469405	0	0	0	0	0
3L	2469912	0	0	0	0	0
3L	2473344	0	0	0	0	0
3L	2481805	0	0	0	0	0
3L	2498728	0	0	0	94	94
3L	2499964	0	1	0	1105	1106
3L	2519293	0	0	0	1	1
3L	2578670	0	0	0	0	0
3L	2657532	0	0	0	116	116
3L	2665990	0	27	0	47	74
3L	2666151	0	52	0	16	68
3L	2773256	1	0	0	50	51
3L	2773526	0	0	0	43	43
3L	2777176	48	0	0	0	48
3L	2778433	31	0	0	0	31
3L	2778439	38	0	0	0	38
3L	2784069	0	11	0	0	11
3L	2784359	0	0	13	0	13
3L	2785524	0	0	18	0	18
3L	2785531	0	0	0	18	18
3L	2785536	0	0	0	18	18
3L	2785542	0	19	0	0	19
3L	2785610	0	21	0	0	21
3L	2785621	0	0	0	21	21
3L	2785658	20	0	0	0	20
3L	2786034	0	0	0	0	0
3L	2791593	0	0	0	56	56
3L	2799685	0	0	0	0	0
3L	2882059	0	0	0	0	0
3L	2924789	189	0	21	0	210
3L	2924790	191	0	22	0	213
3L	2924829	155	0	59	0	214
3L	2925090	48	0	122	0	170
3L	2925255	15	0	147	0	162
3L	2925550	66	0	0	0	66
3L	2939953	83	0	50	0	133
3L	2940825	194	0	5	0	199
3L	2940919	174	0	28	0	202
3L	2941131	44	0	144	1	189
3L	2941132	19	0	170	0	189
3L	2941311	160	0	6	0	166
3L	2941312	11	0	155	0	166
3L	2941364	11	0	160	0	171
3L	2941396	38	0	137	0	175
3L	2941425	72	0	115	0	187
3L	2941426	6	0	182	0	188
3L	2961305	0	0	0	0	0
3L	3086223	175	0	54	0	229
3L	3114961	0	0	0	63	63
3L	3150180	0	0	0	0	0
3L	3226015	20	0	10	0	30
3L	3311439	0	1	0	0	1
3L	3359345	58	0	51	1	110
3L	3361215	0	121	0	0	121
3L	3371858	0	52	0	34	86
3L	3371901	0	33	0	58	91
3L	3371976	0	25	0	92	117
3L	3407053	0	0	0	0	0
3L	3442381	0	0	0	0	0
3L	3471786	0	0	0	64	64
3L	3555912	0	0	0	0	0
3L	3729820	0	0	0	0	0
3L	3761976	0	0	0	4	4
3L	3762337	0	0	0	2	2
3L	3781259	0	0	0	69	69
3L	3786975	0	0	0	0	0
3L	3815844	0	0	0	0	0
3L	3837134	0	0	140	0	140
3L	3892642	0	0	70	0	70
3L	3904309	4	0	0	0	4
3L	3988087	97	0	15	0	112
3L	4089220	0	0	0	2	2
3L	4092326	620	0	8	0	628
3L	4172458	42	0	0	0	42
3L	4198341	28	0	30	0	58
3L	4264563	0	0	0	0	0
3L	4307932	0	0	0	0	0
3L	4308806	0	0	0	0	0
3L	4314575	0	0	0	0	0
3L	4314576	0	0	0	0	0
3L	4314586	0	0	0	0	0
3L	4316475	0	0	0	0	0
3L	4317484	0	1	0	0	1
3L	4317522	0	0	0	0	0
3L	4317524	0	0	0	0	0
3L	4317564	0	0	1	0	1
3L	4318105	0	0	0	0	0
3L	4318481	0	0	0	0	0
3L	4369162	0	307	0	87	394
3L	4369184	0	326	0	65	391
3L	4369185	0	189	0	201	390
3L	4369207	1	45	0	427	473
3L	4369208	0	35	1	432	468
3L	4369213	0	53	0	424	477
3L	4369313	0	0	0	456	456
3L	4369422	0	121	0	222	343
3L	4369445	0	26	0	282	308
3L	4369455	0	24	0	335	359
3L	4369459	0	42	0	307	349
3L	4429963	11	0	331	0	342
3L	4429967	186	0	155	0	341
3L	4430199	91	0	38	2	131
3L	4430208	23	0	120	0	143
3L	4431761	22	0	200	0	222
3L	4432486	140	0	181	0	321
3L	4432487	61	0	259	0	320
3L	4433319	255	1	159	0	415
3L	4433320	40	0	371	0	411
3L	4446288	0	0	0	0	0
3L	4584256	19	0	86	0	105
3L	4585849	100	0	58	0	158
3L	4585851	130	0	30	0	160
3L	4585858	106	0	51	0	157
3L	4585859	23	0	131	0	154
3L	4585865	96	0	57	0	153
3L	4586039	114	0	13	0	127
3L	4586053	88	0	44	0	132
3L	4586714	388	0	94	1	483
3L	4586715	67	0	411	0	478
3L	4590437	202	0	47	0	249
3L	4590448	193	0	57	1	251
3L	4590461	243	0	20	0	263
3L	4590463	248	0	17	0	265
3L	4590484	254	0	29	0	283
3L	4590685	113	0	162	0	275
3L	4590708	209	0	95	0	304
3L	4590709	57	0	245	1	303
3L	4591116	107	0	134	0	241
3L	4591123	224	0	25	0	249
3L	4591132	231	0	39	0	270
3L	4591179	251	0	47	0	298
3L	4591222	287	1	41	0	329
3L	4591226	341	0	14	0	355
3L	4591259	262	0	41	0	303
3L	4591369	271	0	38	0	309
3L	4591744	283	0	16	0	299
3L	4732441	0	0	0	0	0
3L	4811851	0	0	8	0	8
3L	4822418	79	0	1	0	80
3L	4822420	78	0	0	0	78
3L	4867777	0	0	0	0	0
3L	4897294	0	1	0	0	1
3L	4985909	0	0	0	0	0
3L	4986257	0	0	0	0	0
3L	4986611	0	0	0	0	0
3L	4986891	0	0	0	0	0
3L	5045427	0	0	0	0	0
3L	5102529	0	0	0	0	0
3L	5116849	0	1	0	0	1
3L	5133159	7	0	0	0	7
3L	5133686	0	0	0	0	0
3L	5135062	57	0	0	0	57
3L	5135116	66	0	0	0	66
3L	5139737	27	0	0	0	27
3L	5144164	16	0	0	0	16
3L	5157874	0	19	0	222	241
3L	5160640	0	1	0	142	143
3L	5171594	0	0	0	0	0
3L	5171618	0	0	0	0	0
3L	5185014	0	1	0	1	2
3L	5188016	0	0	0	2	2
3L	5191766	0	0	0	2	2
3L	5192055	0	0	0	0	0
3L	5212866	7	0	0	0	7
3L	5212915	0	5	0	0	5
3L	5212920	0	5	0	0	5
3L	5213133	0	0	0	0	0
3L	5213134	0	0	0	0	0
3L	5247676	0	0	0	18	18
3L	5334897	0	0	0	0	0
3L	5347418	0	0	0	0	0
3L	5435357	1	0	0	0	1
3L	5664597	1	0	3	0	4
3L	5692734	5	0	1	0	6
3L	5696130	8	0	17	0	25
3L	5740525	49	0	66	0	115
3L	5743791	12	0	0	0	12
3L	5745060	73	0	12	0	85
3L	5746701	355	0	1	0	356
3L	5746708	332	0	27	0	359
3L	5746772	321	0	64	0	385
3L	5750034	0	0	0	0	0
3L	5764525	0	0	0	97	97
3L	5815976	0	0	15	1	16
3L	6008890	0	0	0	0	0
3L	6008957	0	0	0	0	0
3L	6009017	0	0	0	0	0
3L	6062381	0	0	0	0	0
3L	6193542	31	0	0	0	31
3L	6285897	0	0	0	0	0
3L	6331348	26	0	0	0	26
3L	6459287	0	0	0	0	0
3L	6506202	0	0	0	0	0
3L	6506212	0	0	0	0	0
3L	6534871	0	0	0	0	0
3L	6641116	0	0	0	0	0
3L	6643565	0	0	0	0	0
3L	6643648	0	0	0	0	0
3L	6643649	0	0	0	0	0
3L	6643749	0	0	0	0	0
3L	6643752	0	0	0	0	0
3L	6689091	0	0	0	0	0
3L	6689204	0	0	0	0	0
3L	6694843	0	0	0	1	1
3L	6734513	52	0	0	0	52
3L	6754914	1	0	0	30	31
3L	6769182	0	0	0	0	0
3L	6786307	0	0	0	0	0
3L	6800394	0	0	3	0	3
3L	6800402	0	0	0	3	3
3L	6949680	0	96	1	468	565
3L	6949683	0	22	0	542	564
3L	6949688	0	146	0	447	593
3L	6949690	0	104	0	492	596
3L	6950110	0	232	2	477	711
3L	6950168	0	55	0	925	980
3L	6954754	1	552	0	721	1274
3L	7021467	0	0	0	0	0
3L	7059577	0	0	0	26	26
3L	7180438	0	54	0	49	103
3L	7218079	0	0	0	0	0
3L	7235679	0	0	0	0	0
3L	7236912	0	0	0	1	1
3L	7324105	0	0	0	19	19
3L	7326096	10	0	0	0	10
3L	7417841	0	0	0	0	0
3L	7650269	0	0	0	0	0
3L	7654672	0	13	0	49	62
3L	7665256	605	0	0	1	606
3L	7666636	0	30	0	29	59
3L	7694236	0	0	0	1	1
3L	7696248	0	1	0	7	8
3L	7830703	0	14	0	24	38
3L	7923214	0	0	0	0	0
3L	7928680	0	106	0	38	144
3L	7939905	0	0	0	0	0
3L	7960324	0	0	0	0	0
3L	7979842	0	0	0	1	1
3L	8041599	0	0	0	0	0
3L	8066395	0	0	0	0	0
3L	8120375	0	0	79	1	80
3L	8120519	0	0	99	0	99
3L	8121502	4	0	0	0	4
3L	8126738	0	0	34	0	34
3L	8126864	28	0	0	0	28
3L	8184846	0	0	50	0	50
3L	8185142	0	0	5	0	5
3L	8228580	0	0	0	0	0
3L	8375374	0	0	0	0	0
3L	8434395	0	0	0	152	152
3L	8444869	0	6	0	0	6
3L	8492631	0	0	0	0	0
3L	8532834	0	0	0	61	61
3L	8532845	0	57	0	0	57
3L	8588267	0	0	187	1	188
3L	8588835	6	0	0	0	6
3L	8589446	7	0	0	0	7
3L	8597507	347	0	0	0	347
3L	8648332	11747	3	1	3	11754
3L	8678627	0	0	77	0	77
3L	8678628	0	0	78	0	78
3L	8678673	0	0	91	0	91
3L	8719077	0	0	19	0	19
3L	8724069	0	0	8	0	8
3L	8736015	0	0	0	2	2
3L	8740095	0	25	0	397	422
3L	8759599	0	0	16	0	16
3L	8775212	0	0	1	0	1
3L	8786152	0	0	71	0	71
3L	8798415	0	0	65	0	65
3L	8827752	0	0	54	0	54
3L	8839904	0	0	0	0	0
3L	8844956	0	0	0	0	0
3L	8850667	0	0	1	0	1
3L	8885355	0	0	0	0	0
3L	8892723	0	0	2	0	2
3L	8913159	0	0	0	0	0
3L	8913856	0	0	0	0	0
3L	8913897	0	0	0	0	0
3L	8931961	26	0	0	0	26
3L	8940166	77	0	0	0	77
3L	8983591	0	221	0	0	221
3L	8985580	0	16	0	0	16
3L	8987752	0	0	0	94	94
3L	8991591	0	40	0	0	40
3L	8993217	0	38	0	0	38
3L	8997822	0	16	0	0	16
3L	9100899	0	3	0	36	39
3L	9124178	0	0	0	2	2
3L	9124180	0	0	0	1	1
3L	9124570	0	3	0	4	7
3L	9144950	256	0	0	0	256
3L	9146324	122	0	0	0	122
3L	9147825	0	1	0	51	52
3L	9149081	0	0	0	89	89
3L	9151835	0	21	0	114	135
3L	9151836	0	12	0	127	139
3L	9155185	0	48	0	123	171
3L	9155218	0	158	0	6	164
3L	9161860	0	3	0	7	10
3L	9161861	0	3	0	10	13
3L	9161863	0	2	0	11	13
3L	9161864	0	1	0	12	13
3L	9161865	0	1	0	13	14
3L	9162917	0	47	0	56	103
3L	9162924	0	19	0	75	94
3L	9172898	0	0	6	0	6
3L	9258715	7	0	0	0	7
3L	9263686	0	1	0	0	1
3L	9270392	0	0	75	0	75
3L	9282077	4	0	0	0	4
3L	9287571	0	0	0	49	49
3L	9341681	12	0	0	0	12
3L	9378596	0	0	0	53	53
3L	9488590	0	0	0	2	2
3L	9497783	0	0	0	6	6
3L	9562249	0	0	0	0	0
3L	9566820	2	0	0	0	2
3L	9566821	2	0	0	0	2
3L	9587305	5	0	0	0	5
3L	9608849	0	2	0	0	2
3L	9622044	0	0	21	0	21
3L	9625888	0	0	12	0	12
3L	9631909	0	36	0	0	36
3L	9632368	0	165	0	0	165
3L	9633307	0	124	0	0	124
3L	9644938	18	0	0	0	18
3L	9645414	0	0	0	28	28
3L	9648209	0	0	0	0	0
3L	9649368	0	2	0	0	2
3L	9666680	0	0	0	0	0
3L	9668976	0	50	0	24	74
3L	9682712	0	0	1	0	1
3L	9682988	4	0	0	0	4
3L	9686533	0	0	0	33	33
3L	9688751	0	0	0	32	32
3L	9709045	3	0	124	0	127
3L	9717933	0	0	0	7	7
3L	9724380	0	0	0	8	8
3L	9724514	0	7	0	0	7
3L	9724607	7	0	0	0	7
3L	9730982	1355	0	1	0	1356
3L	9734333	0	0	0	200	200
3L	9736382	0	0	0	22	22
3L	9736627	0	0	0	0	0
3L	9738180	0	0	0	347	347
3L	9740249	0	0	0	9	9
3L	9740401	0	13	0	0	13
3L	9774568	0	0	0	0	0
3L	9799424	0	0	0	0	0
3L	9807026	0	0	0	0	0
3L	9814841	0	0	0	0	0
3L	9815342	0	0	1	0	1
3L	9816197	0	0	1	0	1
3L	9816249	0	1	0	0	1
3L	9816250	0	0	1	0	1
3L	9816252	0	0	2	0	2
3L	9816265	21	0	0	0	21
3L	9816267	0	0	23	0	23
3L	9817489	0	0	0	0	0
3L	9819018	0	0	0	0	0
3L	9821256	0	0	0	0	0
3L	9821464	0	0	0	0	0
3L	9821472	0	0	0	0	0
3L	9821474	0	0	0	0	0
3L	9821481	0	0	0	0	0
3L	9821685	0	0	0	12	12
3L	9833291	317	0	35	0	352
3L	9833294	261	0	111	0	372
3L	9833300	222	0	167	0	389
3L	9833301	128	0	254	0	382
3L	9833364	303	0	23	0	326
3L	9833369	60	1	280	0	341
3L	9833370	313	0	31	0	344
3L	9833459	190	0	117	0	307
3L	9833484	266	0	49	1	316
3L	9833487	290	0	20	0	310
3L	9867222	113	0	7	0	120
3L	9867339	96	0	121	0	217
3L	9885244	0	14	0	0	14
3L	9885764	0	0	0	14	14
3L	9886836	0	0	0	12	12
3L	9892134	27	0	26	0	53
3L	9943795	0	0	0	0	0
3L	9943907	0	0	0	0	0
3L	9972754	3	0	0	0	3
3L	9974737	12	0	0	0	12
3L	10023375	0	0	0	0	0
3L	10153722	0	0	0	4	4
3L	10182898	0	0	0	1	1
3L	10182954	0	1	0	1	2
3L	10185757	0	4	0	7	11
3L	10197944	0	0	0	1	1
3L	10287759	0	0	2	0	2
3L	10358012	0	0	0	0	0
3L	10423429	0	0	0	0	0
3L	10478991	0	0	0	0	0
3L	10516387	14	0	7	0	21
3L	10556226	0	0	1	0	1
3L	10583448	0	6	0	0	6
3L	10644076	0	0	39	0	39
3L	10659046	0	0	0	0	0
3L	10672257	0	0	0	0	0
3L	10785536	0	0	0	0	0
3L	10787010	0	0	0	0	0
3L	10787012	0	0	0	0	0
3L	10820249	0	0	0	0	0
3L	10848012	0	0	0	0	0
3L	10944093	0	0	0	0	0
3L	11038040	0	4	0	138	142
3L	11067981	20	0	0	0	20
3L	11073860	0	0	0	87	87
3L	11166174	0	17	0	0	17
3L	11166793	11	0	0	0	11
3L	11166799	0	0	0	10	10
3L	11166802	0	0	0	11	11
3L	11166932	0	0	0	15	15
3L	11175776	3	0	4	0	7
3L	11175795	1	0	5	0	6
3L	11175891	7	0	0	0	7
3L	11175895	7	0	0	0	7
3L	11175896	7	0	0	0	7
3L	11176183	3	0	1	0	4
3L	11176185	3	0	1	0	4
3L	11178469	0	0	159	0	159
3L	11203066	0	0	0	34	34
3L	11209891	0	0	26	0	26
3L	11211185	47	0	0	0	47
3L	11211200	45	1	0	0	46
3L	11218031	0	0	0	0	0
3L	11218035	0	0	0	0	0
3L	11218227	0	1	0	0	1
3L	11225111	104	0	0	0	104
3L	11225150	61	0	60	0	121
3L	11280036	0	0	0	0	0
3L	11519814	0	5	0	0	5
3L	11552592	0	0	0	1	1
3L	11553320	0	1	0	2	3
3L	11553330	0	3	0	0	3
3L	11553333	0	0	0	3	3
3L	11559570	0	0	0	1	1
3L	11599583	4	0	0	0	4
3L	11650023	0	0	0	70	70
3L	11670833	0	4	0	0	4
3L	11734662	0	0	0	73	73
3L	11746631	0	0	0	0	0
3L	11764981	0	0	0	0	0
3L	11803246	0	0	0	0	0
3L	11807770	0	0	0	0	0
3L	11815790	0	26	0	0	26
3L	11824846	13	0	0	0	13
3L	11827577	0	0	0	5	5
3L	11837250	0	0	0	0	0
3L	11837265	0	0	0	0	0
3L	11857720	0	0	0	1	1
3L	11857797	1	0	0	0	1
3L	11857887	0	0	2	0	2
3L	11857906	0	0	2	0	2
3L	11956759	0	0	0	0	0
3L	11964188	0	1	0	0	1
3L	11974542	0	0	0	0	0
3L	12022418	0	0	0	0	0
3L	12023402	0	0	0	0	0
3L	12066158	0	0	0	0	0
3L	12070965	0	32	0	0	32
3L	12100697	0	0	0	0	0
3L	12105494	0	0	0	0	0
3L	12123225	0	0	0	655	655
3L	12211671	0	61	0	43	104
3L	12211756	0	14	0	76	90
3L	12212148	0	100	0	1	101
3L	12212309	0	112	0	5	117
3L	12239964	0	0	0	0	0
3L	12244780	0	0	0	0	0
3L	12252166	0	0	0	0	0
3L	12297495	0	0	0	0	0
3L	12423647	0	0	0	0	0
3L	12426521	0	0	0	0	0
3L	12430208	0	0	0	0	0
3L	12440786	0	0	0	0	0
3L	12445033	0	0	0	0	0
3L	12463065	0	0	0	5	5
3L	12463742	0	0	21	0	21
3L	12471180	0	0	0	0	0
3L	12471570	0	0	0	0	0
3L	12493418	0	0	2	0	2
3L	12494398	0	0	0	0	0
3L	12508254	2	0	0	0	2
3L	12508840	0	4	0	0	4
3L	12509140	0	0	0	0	0
3L	12510503	0	0	0	0	0
3L	12519462	158	0	0	0	158
3L	12519598	157	0	0	0	157
3L	12524172	2	0	0	0	2
3L	12527022	0	0	0	0	0
3L	12529862	0	0	0	2	2
3L	12546839	0	0	0	1	1
3L	12691864	0	0	0	0	0
3L	12731393	0	0	0	0	0
3L	12731797	0	0	0	0	0
3L	12768257	19	0	0	0	19
3L	12826688	0	3	0	0	3
3L	12853773	0	0	109	1	110
3L	12856591	44	0	24	0	68
3L	13007953	0	0	0	0	0
3L	13020448	0	22	1	153	176
3L	13038438	13	0	44	0	57
3L	13194742	0	0	0	0	0
3L	13194835	0	0	0	0	0
3L	13195237	0	0	0	0	0
3L	13195308	0	0	0	0	0
3L	13196156	0	0	0	0	0
3L	13196212	0	0	0	0	0
3L	13218792	0	0	0	0	0
3L	13225212	0	0	0	0	0
3L	13309717	0	0	0	0	0
3L	13312105	0	0	0	0	0
3L	13312111	0	0	0	0	0
3L	13418107	0	4	0	3	7
3L	13435185	0	3	0	9	12
3L	13467599	0	96	0	0	96
3L	13467636	0	114	0	0	114
3L	13467653	0	114	0	0	114
3L	13480590	0	0	42	0	42
3L	13492027	0	0	0	1	1
3L	13494294	2	0	0	0	2
3L	13494298	2	0	0	0	2
3L	13494304	2	0	0	0	2
3L	13494305	0	0	2	0	2
3L	13494355	0	0	0	2	2
3L	13494364	2	0	0	0	2
3L	13494365	0	0	2	0	2
3L	13494372	0	2	0	0	2
3L	13494373	0	2	0	0	2
3L	13494374	2	0	0	0	2
3L	13494390	0	0	3	0	3
3L	13494392	0	3	0	0	3
3L	13494408	0	2	0	0	2
3L	13494438	3	0	0	0	3
3L	13494439	0	3	0	0	3
3L	13494441	3	0	0	0	3
3L	13494445	2	0	0	0	2
3L	13494448	3	0	0	0	3
3L	13494451	3	0	0	0	3
3L	13494457	0	0	3	0	3
3L	13494472	0	0	0	3	3
3L	13494497	3	0	0	0	3
3L	13494498	1	0	0	0	1
3L	13494519	0	3	0	0	3
3L	13494520	0	0	0	4	4
3L	13494596	0	0	4	0	4
3L	13494693	2	0	0	0	2
3L	13494842	0	0	21	0	21
3L	13502410	0	0	0	11	11
3L	13535416	18	0	29	0	47
3L	13600286	0	0	0	0	0
3L	13703883	0	0	0	0	0
3L	13858574	26	0	5	0	31
3L	13859907	8	0	0	0	8
3L	13869566	54	0	90	0	144
3L	13871006	0	0	0	45	45
3L	13888962	0	3	0	13	16
3L	13901738	0	111	0	72	183
3L	13912261	0	0	0	1	1
3L	13919434	0	0	0	21	21
3L	13927002	0	0	0	15	15
3L	13929952	10	0	18	0	28
3L	13933146	77	0	0	0	77
3L	13933176	86	0	0	0	86
3L	13959984	8	0	28	0	36
3L	13962782	0	0	0	8	8
3L	13967324	1	0	3	0	4
3L	13974178	60	0	0	0	60
3L	14000997	0	0	0	21	21
3L	14001118	0	6	0	11	17
3L	14063120	0	0	0	0	0
3L	14066713	68	0	0	0	68
3L	14070532	0	0	0	0	0
3L	14071510	0	0	0	14	14
3L	14084672	0	0	0	0	0
3L	14084674	0	0	0	0	0
3L	14090360	0	0	0	0	0
3L	14090416	0	0	0	0	0
3L	14090417	0	0	0	0	0
3L	14096104	0	0	0	0	0
3L	14096107	0	0	0	0	0
3L	14096112	0	0	0	0	0
3L	14096121	0	0	0	0	0
3L	14096133	0	0	0	0	0
3L	14096136	0	0	0	0	0
3L	14096146	0	0	0	0	0
3L	14097465	0	0	0	0	0
3L	14097466	0	0	0	0	0
3L	14097468	0	0	0	0	0
3L	14097688	0	0	0	0	0
3L	14097689	0	0	0	0	0
3L	14097845	0	0	0	0	0
3L	14097870	0	0	0	0	0
3L	14097874	0	0	0	0	0
3L	14098080	0	0	0	0	0
3L	14098096	0	0	0	0	0
3L	14098097	0	0	0	0	0
3L	14098360	0	0	0	0	0
3L	14098377	0	0	0	0	0
3L	14098378	0	0	0	0	0
3L	14098379	0	0	0	0	0
3L	14100722	0	0	0	0	0
3L	14100724	0	0	0	0	0
3L	14111714	0	0	0	0	0
3L	14112636	0	6	0	14	20
3L	14212209	0	0	67	0	67
3L	14227988	1	0	0	0	1
3L	14235297	0	0	0	1	1
3L	14236740	12	0	0	0	12
3L	14368016	11	0	13	0	24
3L	14426456	0	0	0	0	0
3L	14439493	0	0	0	0	0
3L	14755055	0	0	0	1	1
3L	14764947	49	0	20	0	69
3L	14799253	39	0	5	0	44
3L	14862538	0	0	0	0	0
3L	14882352	0	0	0	0	0
3L	15043222	0	0	0	0	0
3L	15102878	1	0	0	0	1
3L	15102879	0	0	0	1	1
3L	15102886	1	0	0	0	1
3L	15102895	0	0	0	1	1
3L	15102896	1	0	0	0	1
3L	15102897	0	0	0	1	1
3L	15102934	0	0	0	0	0
3L	15102939	1	0	0	0	1
3L	15472441	0	0	0	0	0
3L	15517405	0	0	0	1	1
3L	15532890	0	0	0	0	0
3L	15555171	0	0	0	0	0
3L	15658259	0	0	0	0	0
3L	15658274	0	0	0	0	0
3L	15659522	0	0	0	0	0
3L	15757800	0	0	0	0	0
3L	15893762	0	17	0	23	40
3L	15895755	0	0	0	1	1
3L	16052231	2	0	3	0	5
3L	16111589	0	29	0	71	100
3L	16181016	0	0	0	0	0
3L	16181038	0	0	0	0	0
3L	16181052	0	0	0	0	0
3L	16181053	0	0	0	0	0
3L	16181094	0	0	0	0	0
3L	16182056	0	0	0	0	0
3L	16182169	0	0	0	0	0
3L	16182170	0	0	0	0	0
3L	16186140	0	0	0	0	0
3L	16186145	0	0	0	0	0
3L	16186363	0	0	0	0	0
3L	16254434	0	0	0	0	0
3L	16254435	0	0	0	0	0
3L	16255064	1	0	0	0	1
3L	16255072	0	0	1	0	1
3L	16262552	0	0	0	0	0
3L	16270810	0	0	0	0	0
3L	16291947	0	0	0	0	0
3L	16577155	0	0	0	0	0
3L	16616020	20	0	0	0	20
3L	16616021	0	0	0	20	20
3L	16617760	0	0	0	0	0
3L	16642757	0	0	0	0	0
3L	16645041	0	0	0	0	0
3L	16674672	0	0	0	0	0
3L	16678530	0	0	0	125	125
3L	16686521	0	0	0	0	0
3L	16688610	0	0	0	0	0
3L	16692734	0	0	0	0	0
3L	16728214	0	0	0	0	0
3L	16731471	0	0	0	0	0
3L	16736878	0	0	0	0	0
3L	16758529	0	0	0	0	0
3L	16786895	110	0	0	0	110
3L	16786980	0	0	0	0	0
3L	16908885	1	0	0	0	1
3L	16910270	0	0	0	0	0
3L	16968101	0	0	0	359	359
3L	17075627	0	6	0	1	7
3L	17378242	0	0	0	0	0
3L	17389187	0	0	0	0	0
3L	17425746	0	0	8	0	8
3L	17451133	17	0	0	0	17
3L	17475161	5	0	0	0	5
3L	17597746	0	23	0	7	30
3L	17668401	0	0	0	26	26
3L	17689993	0	0	0	0	0
3L	17726464	0	0	0	0	0
3L	17742206	0	0	0	1	1
3L	17951569	121	0	0	0	121
3L	17979662	0	0	0	0	0
3L	17979744	0	0	0	0	0
3L	18027635	0	0	0	1	1
3L	18087658	0	0	0	0	0
3L	18090225	0	0	0	0	0
3L	18132571	0	0	0	1	1
3L	18181206	0	0	0	0	0
3L	18189120	0	0	0	0	0
3L	18281392	0	0	0	0	0
3L	18281522	0	0	0	0	0
3L	18555038	0	0	0	0	0
3L	18596316	0	0	0	0	0
3L	18670895	0	0	0	85	85
3L	18682575	9	0	0	0	9
3L	18685220	0	4	0	9	13
3L	18685424	0	14	0	8	22
3L	18728861	0	0	0	0	0
3L	18800841	17	0	0	0	17
3L	18819562	0	0	0	17	17
3L	18878588	0	0	0	144	144
3L	18878936	0	0	0	320	320
3L	18897569	0	0	0	0	0
3L	18922609	0	0	0	10	10
3L	18922733	0	0	0	13	13
3L	19052915	0	0	0	0	0
3L	19055200	0	0	0	0	0
3L	19066432	0	0	0	34	34
3L	19067899	0	0	0	31	31
3L	19070611	0	0	0	0	0
3L	19106047	0	6	0	10	16
3L	19110288	0	17	0	15	32
3L	19147008	0	0	0	0	0
3L	19160049	0	0	0	0	0
3L	19283200	0	20	0	91	111
3L	19283264	0	54	0	52	106
3L	19283265	0	12	0	97	109
3L	19341568	0	0	0	43	43
3L	19369627	0	0	0	0	0
3L	19371398	0	0	0	0	0
3L	19399656	0	0	0	0	0
3L	19411978	0	0	0	0	0
3L	19501470	0	0	0	0	0
3L	19513044	0	0	0	0	0
3L	19516477	0	0	0	0	0
3L	19531391	0	0	0	0	0
3L	19542365	0	0	0	54	54
3L	19545728	0	0	7	0	7
3L	19578009	0	1	0	0	1
3L	19618855	0	0	0	0	0
3L	19689767	1052	0	180	0	1232
3L	19689870	120	0	670	0	790
3L	19689871	15	0	768	0	783
3L	19932956	0	0	0	0	0
3L	20035022	0	0	0	0	0
3L	20098494	0	0	0	133	133
3L	20156776	0	4	0	12	16
3L	20156958	0	13	0	24	37
3L	20252103	2	0	7	0	9
3L	20353020	0	0	0	25	25
3L	20379678	54	0	13	0	67
3L	20391933	0	0	0	15	15
3L	20420837	0	5	0	0	5
3L	20427294	0	17	0	6	23
3L	20428234	1	14	0	1	16
3L	20453518	0	0	0	1	1
3L	20465542	0	0	0	1	1
3L	20502571	2	0	0	0	2
3L	20502628	3	0	1	0	4
3L	20503418	2	0	0	0	2
3L	20523500	0	23	0	39	62
3L	20598406	0	3	0	2	5
3L	20598874	0	0	0	23	23
3L	20690411	0	0	0	0	0
3L	20768391	0	0	0	15	15
3L	20773150	56	0	145	0	201
3L	20773190	54	0	141	0	195
3L	20773546	167	0	11	0	178
3L	20773569	142	0	46	0	188
3L	20773589	153	0	31	1	185
3L	20773609	166	1	35	0	202
3L	20773610	149	0	52	0	201
3L	20802315	0	0	0	0	0
3L	20817830	0	0	0	0	0
3L	20820474	35	0	0	0	35
3L	20867520	0	0	0	0	0
3L	20879740	0	0	0	0	0
3L	20885034	0	30	0	61	91
3L	20942629	0	0	0	0	0
3L	20975576	0	0	0	0	0
3L	21072555	191	0	0	0	191
3L	21115651	0	0	0	0	0
3L	21118999	0	0	1	0	1
3L	21130550	0	0	0	0	0
3L	21130556	0	0	0	0	0
3L	21130559	0	0	0	0	0
3L	21130564	0	0	0	0	0
3L	21130610	0	0	0	0	0
3L	21130611	0	0	0	0	0
3L	21130618	0	0	0	0	0
3L	21130621	0	0	0	0	0
3L	21164936	0	0	0	0	0
3L	21179937	0	58	0	0	58
3L	21195648	0	0	0	3	3
3L	21203253	22	0	0	0	22
3L	21204995	2	0	0	0	2
3L	21205002	2	0	0	0	2
3L	21207897	59	0	5	0	64
3L	21210325	17	0	37	0	54
3L	21213292	40	0	47	0	87
3L	21226173	0	0	0	0	0
3L	21309631	0	0	0	0	0
3L	21333937	13	0	54	0	67
3L	21390253	0	0	0	0	0
3L	21390256	0	0	0	0	0
3L	21390260	0	0	0	0	0
3L	21390271	0	0	0	0	0
3L	21390275	0	0	0	0	0
3L	21390282	0	0	0	0	0
3L	21390294	0	0	0	0	0
3L	21390295	0	0	0	0	0
3L	21390303	0	0	0	0	0
3L	21390314	0	0	0	0	0
3L	21391007	0	0	0	0	0
3L	21391234	0	0	0	0	0
3L	21391240	0	0	0	0	0
3L	21644394	0	0	0	0	0
3L	21644396	0	0	0	0	0
3L	21644402	0	0	0	0	0
3L	21696292	0	0	0	0	0
3L	21696294	0	0	0	0	0
3L	21696345	0	0	1	0	1
3L	21696349	0	1	0	0	1
3L	21696352	0	0	0	1	1
3L	21696354	0	0	0	1	1
3L	21696356	0	1	0	0	1
3L	21696357	0	0	1	0	1
3L	21696361	0	1	0	0	1
3L	21696364	0	0	0	1	1
3L	21696375	1	0	0	0	1
3L	21696397	0	1	0	0	1
3L	21696400	0	1	0	0	1
3L	21696404	0	0	1	0	1
3L	21696405	0	0	1	0	1
3L	21696410	0	0	1	0	1
3L	21714311	0	0	0	0	0
3L	21715425	0	0	0	0	0
3L	21717050	0	0	0	0	0
3L	21728957	3	0	0	0	3
3L	21845812	0	0	0	0	0
3L	22132252	0	0	0	0	0
3L	22133068	0	0	0	0	0
3L	22133070	0	0	0	0	0
3L	22169386	0	0	0	0	0
3L	22268084	4	0	4	0	8
3L	22273143	381	0	22	0	403
3L	22273144	393	0	10	0	403
3L	22463672	0	0	0	3	3
3L	22655901	0	0	0	0	0
3L	22731262	0	0	0	0	0
3L	22793765	0	0	0	22	22
3L	22826560	1	0	0	0	1
3L	22827988	0	0	0	0	0
3L	22894950	0	0	0	0	0
3L	22894959	0	0	0	0	0
3L	23022502	25	0	2	0	27
3L	23022517	15	0	12	0	27
3L	23022531	22	0	3	0	25
3L	23022558	12	0	8	0	20
3L	23022565	10	0	12	0	22
3L	23022570	7	0	16	0	23
3L	23022589	5	0	17	0	22
3L	23022624	9	0	10	0	19
3L	23022651	10	0	2	0	12
3L	23022665	14	0	0	0	14
3L	23022696	15	0	1	0	16
3L	23022733	9	0	10	0	19
3L	23022747	12	0	6	0	18
3L	23022860	26	0	0	0	26
3L	23022915	23	0	3	0	26
3L	23023572	22	0	5	0	27
3L	23023737	23	0	6	0	29
3L	23023745	28	0	1	0	29
3L	23023746	25	0	3	0	28
3L	23023752	15	0	17	0	32
3L	23023759	19	0	10	0	29
3L	23023768	7	0	12	0	19
3L	23023772	13	0	14	0	27
3L	23023773	20	0	6	0	26
3L	23023776	21	0	4	0	25
3L	23023778	18	0	9	0	27
3L	23034648	9	0	94	0	103
3L	23035386	115	0	8	0	123
3L	23035498	79	0	17	0	96
3L	23035510	64	0	29	0	93
3L	23036047	87	0	20	0	107
3L	23036053	24	0	77	0	101
3L	23036055	85	0	13	0	98
3L	23036058	0	0	103	0	103
3L	23036059	45	0	59	1	105
3L	23036066	18	0	83	0	101
3L	23036068	42	0	60	0	102
3L	23036071	2	0	98	0	100
3L	23036082	75	0	30	0	105
3L	23036083	96	0	9	0	105
3L	23036084	96	0	12	0	108
3L	23036087	92	0	11	0	103
3L	23036098	77	0	30	0	107
3L	23036101	74	0	29	0	103
3L	23036116	65	0	45	0	110
3L	23036121	81	0	39	0	120
3L	23036453	74	0	28	0	102
3L	23036548	40	0	60	0	100
3L	23036588	45	0	45	0	90
3L	23036631	31	0	74	0	105
3L	23216253	0	0	0	0	0
3L	23228909	1	0	0	0	1
3L	23228910	0	0	1	0	1
3L	23228912	1	0	0	0	1
3L	23228932	2	0	0	0	2
3L	23231321	2	0	0	0	2
3L	23232223	0	0	0	0	0
3L	23241819	1	0	0	0	1
3L	23252714	3	0	1	0	4
3L	23284872	36	0	3	0	39
3L	23286473	123	0	18	0	141
3L	23286550	112	0	19	0	131
3L	23579149	1	0	0	0	1
3L	23742459	12	0	13	0	25
3L	23743265	20	0	0	0	20
3L	23743306	12	0	1	0	13
3L	23796662	0	0	0	0	0
3L	24031604	15	1	17	0	33
3L	24031889	11	0	15	0	26
3L	24031891	11	0	15	0	26
3L	24040526	0	0	0	0	0
3L	24074572	1	0	0	0	1
3L	24074586	0	0	1	0	1
3L	24074603	0	0	1	0	1
3L	24074606	0	0	1	0	1
3L	24074610	0	0	1	0	1
3L	24074617	0	0	1	0	1
3L	24074621	0	0	1	0	1
3L	24074625	0	0	1	0	1
3L	24074665	1	0	0	0	1
3L	24074669	0	0	1	0	1
3L	24074673	0	0	1	0	1
3L	24074677	0	0	1	0	1
3L	24074679	0	0	1	0	1
3L	24074680	1	0	0	0	1
3L	24074682	1	0	0	0	1
3L	24074685	1	0	0	0	1
3L	24074697	1	0	0	0	1
3L	24074700	0	0	1	0	1
3L	24074710	0	0	1	0	1
3L	24074713	0	0	1	0	1
3L	24074747	0	0	0	0	0
3L	24074754	0	0	0	0	0
3L	24074759	0	0	0	0	0
3L	24074986	0	0	0	0	0
3L	24184343	0	0	0	0	0
3L	24184352	0	0	0	0	0
3L	24260884	0	0	0	0	0
3L	24539756	1	0	1	0	2
3L	24574446	0	0	0	0	0
3L	24727794	0	0	2	0	2
3L	24729192	0	0	0	0	0
3L	24729203	0	0	0	0	0
3L	24729209	0	0	0	0	0
3L	24729558	0	0	0	0	0
3L	24734394	0	0	0	0	0
3L	24734409	0	0	0	0	0
3L	24734433	1	0	0	0	1
3L	24734434	1	0	0	0	1
3L	24734444	1	0	0	0	1
3L	24734445	1	0	0	0	1
3L	24734544	1	0	0	0	1
3L	24734545	1	0	0	0	1
3L	24734548	0	0	0	0	0
3L	24734549	1	0	0	0	1
3L	24734550	1	0	0	0	1
3L	24734565	1	0	0	0	1
3L	24734583	1	0	0	0	1
3L	24739737	0	0	0	0	0
3L	24739770	0	0	0	0	0
3L	24739940	0	0	0	0	0
3L	24739953	0	0	0	0	0
3L	25191188	0	0	0	0	0
3L	25404612	0	0	0	2	2
3L	25411101	0	0	0	0	0
3L	25440130	0	0	0	0	0
3L	25487370	0	0	0	0	0
3L	25519478	0	0	0	0	0
3L	25519484	0	0	0	1	1
3L	25519485	0	0	0	1	1
3L	25519514	0	0	0	1	1
3L	25519515	0	0	0	1	1
3L	25519516	0	0	0	1	1
3L	25519519	0	0	0	1	1
3L	25519523	0	0	0	0	0
3L	25519524	0	0	0	1	1
3L	25598311	0	0	0	0	0
3L	25608424	0	0	0	1	1
3L	25608425	0	0	0	1	1
3L	25608436	0	0	0	1	1
3L	25633906	0	0	0	0	0
3L	25633926	0	0	0	0	0
3L	25668383	0	0	0	1	1
3L	25668389	0	0	0	1	1
3L	25668390	0	0	0	1	1
3L	25668438	0	1	0	0	1
3L	25668442	0	0	0	1	1
3L	25668450	0	1	0	0	1
3L	25668451	0	1	0	0	1
3L	25668452	0	0	0	1	1
3L	25668462	0	0	0	0	0
3L	25668464	0	0	0	0	0
3L	25668466	0	0	0	0	0
3L	25668467	0	0	0	0	0
3L	25668501	0	0	0	0	0
3L	25668503	0	0	0	0	0
3L	25668653	0	0	0	1	1
3L	25669834	0	0	0	0	0
3L	25669886	0	0	0	0	0
3L	25669903	0	0	0	0	0
3L	25669904	0	0	0	0	0
3L	25669929	0	0	0	0	0
3L	25669935	0	0	0	0	0
3L	25674685	0	0	1	0	1
3L	25674703	1	0	0	0	1
3L	25674878	3	0	0	0	3
3L	25849333	0	0	0	0	0
3L	25873801	0	0	0	1	1
3L	25920861	0	0	0	0	0
3L	26001042	0	1	0	1	2
3L	26002127	0	0	0	3	3
3L	26002138	0	0	0	3	3
3L	26002140	0	0	0	2	2
3L	26002728	0	0	0	4	4
3L	26003264	0	0	0	7	7
3L	26009778	0	0	0	2	2
3L	26009830	0	0	0	1	1
3L	26012760	0	0	0	1	1
3L	26012768	0	0	0	1	1
3L	26582674	0	0	0	0	0
3L	26594673	0	0	0	0	0
3L	26610401	0	0	0	0	0
3L	26666453	0	0	0	0	0
3L	26667951	0	0	0	0	0
3L	26756592	0	0	0	0	0
3L	27281127	2	0	0	0	2
3L	27281185	2	0	0	0	2
3L	27845559	0	0	0	0	0
3L	27845560	0	0	0	0	0
3L	27845708	0	0	0	0	0
3L	28002470	0	0	0	0	0
3L	28002543	0	0	0	0	0
3L	28002555	0	0	0	0	0
3L	28002560	0	0	0	0	0
3L	28002748	0	0	0	0	0
3L	28002752	0	0	0	0	0
3R	2156963	0	0	0	0	0
3R	3122736	0	0	0	0	0
3R	3122737	0	0	0	0	0
3R	3751950	0	0	4	0	4
3R	4131662	1	0	0	0	1
3R	4185912	20	0	11	0	31
3R	4185926	18	0	13	0	31
3R	4185927	19	0	12	0	31
3R	4185928	25	0	7	0	32
3R	4186013	33	0	1	0	34
3R	4186020	32	0	1	0	33
3R	4186021	30	0	3	0	33
3R	4186029	32	0	1	0	33
3R	4186038	25	0	6	0	31
3R	4186053	25	0	6	0	31
3R	4186057	28	0	3	0	31
3R	4186060	29	0	3	0	32
3R	4186071	29	0	1	0	30
3R	4186077	32	0	0	0	32
3R	4186090	29	0	0	0	29
3R	4186091	28	0	4	0	32
3R	4279033	0	20	0	14	34
3R	4279036	0	21	0	13	34
3R	4279126	0	26	0	7	33
3R	4279127	0	26	0	7	33
3R	4279128	0	16	0	15	31
3R	4297057	144	0	34	0	178
3R	4297067	179	0	4	0	183
3R	4297086	182	0	3	0	185
3R	4297093	179	0	12	0	191
3R	4297095	168	0	26	0	194
3R	4297504	1128	0	809	0	1937
3R	4297517	1506	0	382	0	1888
3R	4297518	1291	0	605	0	1896
3R	4299218	214	0	28	0	242
3R	4299387	196	0	31	0	227
3R	4299391	136	1	87	0	224
3R	4301117	175	0	29	0	204
3R	4301124	210	0	4	0	214
3R	4301140	139	0	41	0	180
3R	4301142	134	0	46	0	180
3R	4301144	173	0	9	0	182
3R	4301150	121	0	74	0	195
3R	4301158	173	0	34	0	207
3R	4301166	199	0	26	0	225
3R	4301174	210	0	32	0	242
3R	4301182	251	0	29	1	281
3R	4301190	217	1	52	0	270
3R	4301192	234	0	39	0	273
3R	4301196	231	0	30	0	261
3R	4301198	200	1	59	1	261
3R	4301200	194	0	78	0	272
3R	4301206	207	1	46	1	255
3R	4301208	217	0	38	0	255
3R	4301212	216	1	47	0	264
3R	4301214	236	0	25	0	261
3R	4301216	241	1	24	0	266
3R	4301240	188	0	65	0	253
3R	4301244	156	0	80	0	236
3R	4301246	185	0	58	0	243
3R	4301248	222	0	30	0	252
3R	4301250	215	0	36	0	251
3R	4301252	273	0	18	0	291
3R	4301254	272	0	55	0	327
3R	4301258	269	0	87	0	356
3R	4365384	133	0	140	0	273
3R	4365385	3	0	268	0	271
3R	4365474	128	0	157	0	285
3R	4493894	0	3	0	4	7
3R	4656505	48	0	13	0	61
3R	4702574	43	0	20	0	63
3R	4944773	2	0	0	0	2
3R	4965472	62	0	0	0	62
3R	5084900	0	0	0	81	81
3R	5236209	0	63	0	429	492
3R	5236328	1	63	0	909	973
3R	5236329	0	335	0	684	1019
3R	5236332	0	957	0	49	1006
3R	5236375	0	584	0	423	1007
3R	5236378	0	521	1	499	1021
3R	5260897	0	0	0	1	1
3R	5260900	1	0	0	0	1
3R	5260901	1	0	0	0	1
3R	5260908	0	0	0	1	1
3R	5260909	1	0	0	0	1
3R	5260910	1	0	0	0	1
3R	5260911	1	0	0	0	1
3R	5260913	0	0	0	1	1
3R	5260914	0	0	0	1	1
3R	5260918	0	0	0	0	0
3R	5260923	0	0	0	1	1
3R	5260926	0	0	0	1	1
3R	5260929	1	0	0	0	1
3R	5260930	0	0	0	1	1
3R	5260931	0	0	0	0	0
3R	5260932	0	0	0	1	1
3R	5260940	0	0	0	0	0
3R	5260941	1	0	0	0	1
3R	5260944	0	0	0	1	1
3R	5260945	1	0	0	0	1
3R	5260946	1	0	0	0	1
3R	5260947	0	0	0	1	1
3R	5260948	1	0	0	0	1
3R	5260949	0	0	0	1	1
3R	5260954	0	0	1	0	1
3R	5260956	0	0	0	1	1
3R	5260957	0	0	0	1	1
3R	5260958	0	0	0	1	1
3R	5260960	0	0	0	1	1
3R	5260961	0	0	0	0	0
3R	5260962	0	0	0	1	1
3R	5260963	0	0	0	1	1
3R	5260964	0	0	0	1	1
3R	5260965	0	0	0	1	1
3R	5260968	0	0	0	0	0
3R	5260969	0	0	0	0	0
3R	5260970	0	0	0	1	1
3R	5260971	1	0	0	0	1
3R	5260972	0	0	0	1	1
3R	5260973	1	0	0	0	1
3R	5260974	1	0	0	0	1
3R	5260976	0	0	0	1	1
3R	5260981	0	0	0	1	1
3R	5260982	0	0	1	0	1
3R	5260984	0	0	0	0	0
3R	5260985	0	0	0	0	0
3R	5260986	0	0	0	0	0
3R	5260987	0	0	0	1	1
3R	5260992	0	0	0	0	0
3R	5260993	0	0	0	0	0
3R	5260994	0	0	0	0	0
3R	5260995	0	0	0	0	0
3R	5260998	0	0	0	0	0
3R	5261005	0	0	0	0	0
3R	5261038	0	0	0	0	0
3R	5261039	0	0	0	0	0
3R	5261045	0	0	0	0	0
3R	5261046	0	0	0	0	0
3R	5261050	0	0	0	0	0
3R	5261052	0	0	0	0	0
3R	5261064	0	0	0	0	0
3R	5261070	0	0	0	0	0
3R	5261071	0	0	0	0	0
3R	5261073	0	0	0	0	0
3R	5268529	7	0	8	0	15
3R	5331180	0	0	0	0	0
3R	5456078	8	0	94	0	102
3R	5510248	0	7	0	44	51
3R	5512061	0	16	0	39	55
3R	5512062	0	15	0	40	55
3R	5579358	24	0	1	0	25
3R	5650231	46	0	47	0	93
3R	5650351	73	0	64	0	137
3R	5686487	17	0	2	0	19
3R	5794759	16	0	0	0	16
3R	5813914	0	0	0	27	27
3R	5835138	7	0	0	0	7
3R	6004380	0	295	0	441	736
3R	6198321	0	0	0	0	0
3R	6410404	0	0	0	0	0
3R	6454240	0	0	0	25	25
3R	6455990	0	11	0	17	28
3R	6456079	0	0	0	30	30
3R	6481790	0	0	0	3	3
3R	6482470	6	0	0	0	6
3R	6483189	0	0	3	0	3
3R	6646984	29	0	0	0	29
3R	6656412	0	0	0	42	42
3R	6825353	0	1	0	11	12
3R	7192775	30	0	252	0	282
3R	7192825	253	0	33	0	286
3R	7472957	0	0	0	4	4
3R	7474763	0	22	0	37	59
3R	7523172	0	0	0	0	0
3R	7527658	0	0	0	0	0
3R	7541970	0	0	0	0	0
3R	7541971	0	0	0	0	0
3R	7578932	0	0	0	0	0
3R	7632065	0	0	0	0	0
3R	7633948	0	0	0	0	0
3R	7857376	1	0	0	171	172
3R	7860890	0	1	0	25	26
3R	7886440	0	27	0	60	87
3R	7959962	0	1	0	0	1
3R	7975631	0	0	0	306	306
3R	8023269	0	46	0	102	148
3R	8025032	0	116	0	0	116
3R	8237633	0	0	0	26	26
3R	8380051	0	15	0	20	35
3R	8380439	0	30	0	19	49
3R	8380442	0	13	0	37	50
3R	8385971	0	0	0	34	34
3R	8386738	0	9	0	29	38
3R	8386758	0	7	0	33	40
3R	8658956	0	0	0	0	0
3R	8659112	0	0	0	0	0
3R	8661419	0	90	0	0	90
3R	8678362	0	0	21	0	21
3R	8736376	0	9	0	38	47
3R	8737810	0	15	0	25	40
3R	8775615	0	595	0	0	595
3R	8788015	0	0	0	0	0
3R	8788344	0	0	0	0	0
3R	8791608	0	1	0	0	1
3R	8795508	0	0	0	0	0
3R	8812828	0	16	0	0	16
3R	8834533	0	179	0	0	179
3R	8836915	0	78	0	15	93
3R	8836926	0	69	0	21	90
3R	8836929	0	50	0	46	96
3R	8837184	0	87	0	32	119
3R	8837191	0	90	0	36	126
3R	8837610	0	69	0	31	100
3R	8851870	0	0	0	0	0
3R	8864798	0	0	0	52	52
3R	8864972	0	0	0	56	56
3R	8867172	0	0	0	1	1
3R	8922284	0	0	0	0	0
3R	8937081	1	0	0	0	1
3R	8952096	0	0	0	0	0
3R	8992964	0	0	1	0	1
3R	9092757	0	2	0	0	2
3R	9094689	0	2	0	0	2
3R	9120444	0	12	0	0	12
3R	9134740	0	2	0	0	2
3R	9147309	0	3	0	0	3
3R	9192083	0	0	0	0	0
3R	9192878	0	1	0	0	1
3R	9195940	0	2	0	0	2
3R	9350774	1	0	0	0	1
3R	9354339	1	0	0	0	1
3R	9385249	0	1	0	0	1
3R	9394121	0	0	0	22	22
3R	9418495	20	0	6	0	26
3R	9418834	20	0	5	0	25
3R	9419410	16	0	10	0	26
3R	9419457	11	0	6	0	17
3R	9421085	6	0	0	0	6
3R	9428183	5	0	1	0	6
3R	9428227	9	0	2	0	11
3R	9428853	6	0	7	0	13
3R	9430861	4	0	4	0	8
3R	9430877	5	0	3	0	8
3R	9448522	287	0	46	0	333
3R	9451570	228	0	0	0	228
3R	9451939	245	0	109	0	354
3R	9455622	0	0	0	10	10
3R	9465643	0	0	0	52	52
3R	9492559	0	0	0	3	3
3R	9525980	0	0	99	0	99
3R	9544703	0	4	0	20	24
3R	9544820	0	4	0	10	14
3R	9591515	40	0	0	0	40
3R	9591859	20	0	0	0	20
3R	9614889	1	0	0	0	1
3R	9666847	0	0	0	0	0
3R	9721112	0	71	0	0	71
3R	9727213	0	89	0	1	90
3R	9729053	0	0	0	133	133
3R	9754511	0	14	0	0	14
3R	9761125	40	0	0	0	40
3R	9769425	115	0	63	0	178
3R	9798395	0	0	0	94	94
3R	9965066	0	0	0	0	0
3R	10029831	0	0	0	0	0
3R	10083460	1	0	0	0	1
3R	10097183	2	0	0	0	2
3R	10194903	29	0	12	0	41
3R	10194972	27	0	10	0	37
3R	10194990	25	0	13	0	38
3R	10195423	264	0	66	0	330
3R	10195426	16	0	319	0	335
3R	10195571	59	0	0	1	60
3R	10195983	187	0	96	0	283
3R	10195984	134	0	164	0	298
3R	10227022	6	0	6	0	12
3R	10228870	85	0	0	0	85
3R	10245424	125	0	32	1	158
3R	10245425	41	0	114	0	155
3R	10305770	42	0	0	0	42
3R	10333913	16	0	0	0	16
3R	10372369	0	0	0	15	15
3R	10391255	6	0	0	0	6
3R	10392923	13	0	0	0	13
3R	10393067	11	0	0	0	11
3R	10394318	16	0	0	0	16
3R	10515812	0	0	0	1	1
3R	10558186	0	0	0	0	0
3R	10584920	0	48	0	65	113
3R	10585180	0	21	0	34	55
3R	10585186	0	23	0	34	57
3R	10766619	0	0	33	0	33
3R	10768515	0	21	0	115	136
3R	10776609	0	0	0	4	4
3R	10782974	0	35	0	0	35
3R	10871792	0	0	0	212	212
3R	11127820	0	0	0	21	21
3R	11193273	0	0	0	0	0
3R	11398476	57	0	104	0	161
3R	11398478	126	0	34	0	160
3R	11450201	0	1	0	0	1
3R	11589338	0	0	0	55	55
3R	11765112	0	10	0	57	67
3R	11801192	0	71	0	43	114
3R	11951530	106	0	56	0	162
3R	11951562	38	0	120	0	158
3R	11953544	0	0	202	1	203
3R	11985293	0	516	0	0	516
3R	11989608	0	28	0	0	28
3R	11994674	0	115	0	0	115
3R	12079394	0	14	0	22	36
3R	12079473	0	8	0	28	36
3R	12096226	37	0	0	0	37
3R	12163774	0	0	0	910	910
3R	12164347	0	125	1	700	826
3R	12215148	17	0	0	0	17
3R	12283052	0	0	0	0	0
3R	12411087	100	0	0	0	100
3R	12416318	35	0	0	0	35
3R	12516932	0	24	0	26	50
3R	12593574	0	1	0	21	22
3R	12593953	0	1	0	24	25
3R	12594802	0	1	0	14	15
3R	12705537	0	0	0	0	0
3R	12741372	0	0	0	0	0
3R	13004750	0	0	77	0	77
3R	13004828	0	0	92	0	92
3R	13018291	8	0	0	0	8
3R	13373289	0	0	0	553	553
3R	13382634	2	0	0	0	2
3R	13399579	0	197	0	0	197
3R	13462029	0	0	62	0	62
3R	13528966	0	0	0	0	0
3R	13663586	0	0	274	0	274
3R	13692592	43	0	31	0	74
3R	13692593	64	0	11	0	75
3R	13725311	0	0	0	0	0
3R	13782016	0	0	5	0	5
3R	13782327	0	0	0	0	0
3R	13959841	0	0	513	0	513
3R	13993445	0	0	0	9	9
3R	14105598	0	23	0	0	23
3R	14108210	0	9	0	0	9
3R	14128425	0	0	52	0	52
3R	14330746	0	0	0	75	75
3R	14363401	0	0	0	0	0
3R	14363405	0	0	0	0	0
3R	14395408	0	0	0	58	58
3R	14409075	0	0	0	66	66
3R	14515193	0	1	0	72	73
3R	14522391	0	0	696	0	696
3R	14623285	0	0	0	79	79
3R	14735962	0	2	0	0	2
3R	14746231	0	0	0	68	68
3R	14746547	0	0	0	101	101
3R	14747108	0	0	0	68	68
3R	14788816	0	0	79	0	79
3R	14809014	0	0	0	1	1
3R	14880381	8	0	0	0	8
3R	14891090	0	0	1259	0	1259
3R	14903154	0	4	0	0	4
3R	14919312	28	0	0	0	28
3R	14996135	0	0	0	0	0
3R	15097165	0	14	0	59	73
3R	15099803	0	0	0	88	88
3R	15287927	3	0	0	0	3
3R	15288163	12	0	0	0	12
3R	15294740	12	0	1	0	13
3R	15296683	960	0	14	0	974
3R	15296695	969	2	8	0	979
3R	15297732	6	0	0	0	6
3R	15298760	9	0	0	0	9
3R	15306860	11	0	0	0	11
3R	15306861	12	0	0	0	12
3R	15384375	24	0	3	0	27
3R	15387222	113	0	94	0	207
3R	15388396	87	0	98	0	185
3R	15392578	147	0	0	0	147
3R	15399446	65	0	91	0	156
3R	15400137	31	0	0	0	31
3R	15400209	20	0	1	0	21
3R	15400211	20	0	0	0	20
3R	15400224	0	0	15	1	16
3R	15401498	0	0	0	146	146
3R	15413254	64	0	136	0	200
3R	15413305	75	0	148	0	223
3R	15413827	2	0	133	0	135
3R	15822468	108	0	32	0	140
3R	15950619	0	0	0	5	5
3R	16003657	15	0	26	0	41
3R	16045954	0	6	0	2	8
3R	16065967	0	0	0	1	1
3R	16087664	0	0	0	0	0
3R	16096668	0	90	0	35	125
3R	16097238	0	31	1	72	104
3R	16302773	47	0	29	0	76
3R	16302775	44	0	30	0	74
3R	16303403	91	0	16	0	107
3R	16303415	85	0	22	0	107
3R	16502786	6	0	0	0	6
3R	16591505	0	0	0	3	3
3R	16633290	137	0	17	0	154
3R	16633369	59	0	71	1	131
3R	16809936	0	0	0	0	0
3R	16827828	0	0	0	0	0
3R	17140246	0	0	0	0	0
3R	17149369	0	0	0	15	15
3R	17502097	0	0	0	0	0
3R	17544578	82	0	44	0	126
3R	17544743	95	0	35	0	130
3R	17750942	0	0	0	9	9
3R	17750957	0	3	0	6	9
3R	17770919	0	53	0	0	53
3R	17771810	0	71	0	0	71
3R	17772922	0	73	0	0	73
3R	17773982	0	6	0	8	14
3R	17774217	0	36	0	23	59
3R	17774401	0	0	29	0	29
3R	17774920	0	1	0	3	4
3R	17775731	0	21	0	0	21
3R	17778660	0	21	0	0	21
3R	17795473	0	0	26	0	26
3R	17796092	0	0	13	0	13
3R	17796780	0	56	0	0	56
3R	17797297	0	62	0	0	62
3R	17799317	0	9	0	0	9
3R	17808359	0	23	0	0	23
3R	17809478	0	10	0	0	10
3R	17852526	0	0	54	0	54
3R	17865673	0	0	57	0	57
3R	17873639	1	107	0	133	241
3R	17874391	0	213	0	0	213
3R	17877415	0	198	0	0	198
3R	17881420	0	120	0	75	195
3R	17881807	0	0	0	207	207
3R	17882765	1	91	0	12	104
3R	17897257	0	5	0	13	18
3R	17905164	0	0	0	66	66
3R	17905999	0	0	0	100	100
3R	17908804	69	0	0	0	69
3R	17938630	0	0	0	0	0
3R	17944246	0	0	0	0	0
3R	17945071	0	0	4	0	4
3R	17945344	0	0	8	0	8
3R	17945752	0	0	10	0	10
3R	17946291	0	0	9	0	9
3R	17947397	55	0	0	0	55
3R	17949372	0	0	0	0	0
3R	17967291	0	0	157	0	157
3R	17967728	144	0	15	0	159
3R	17976866	2	0	1	0	3
3R	17980448	7	0	0	0	7
3R	17986938	3	0	0	0	3
3R	17992257	4	0	0	0	4
3R	17994037	6	0	0	0	6
3R	17994206	3	0	0	0	3
3R	18017356	69	0	0	0	69
3R	18133238	18	0	0	0	18
3R	18199189	0	0	0	25	25
3R	18205263	0	0	0	0	0
3R	18226004	0	0	0	13	13
3R	18236442	43	0	0	0	43
3R	18238159	110	0	0	0	110
3R	18290939	0	11	0	71	82
3R	18355194	0	31	0	18	49
3R	18355198	0	30	0	17	47
3R	18355305	0	20	0	24	44
3R	18360355	0	1	0	13	14
3R	18498021	0	0	0	0	0
3R	18599594	0	1	0	0	1
3R	18674009	11	0	0	0	11
3R	18801700	0	10	0	42	52
3R	18806029	0	5	0	36	41
3R	18824181	0	0	0	1	1
3R	18881308	0	0	0	0	0
3R	18907574	532	0	61	0	593
3R	18907652	158	0	443	0	601
3R	18907675	155	1	418	0	574
3R	18907799	239	2	139	1	381
3R	18907980	344	0	135	0	479
3R	18910005	195	0	11	0	206
3R	18910153	23	0	184	0	207
3R	18970679	312	0	35	0	347
3R	18970692	255	0	79	0	334
3R	18971312	258	0	147	0	405
3R	19081553	0	0	0	0	0
3R	19140149	2	30	0	70	102
3R	19141001	0	22	0	97	119
3R	19218093	0	0	0	1	1
3R	19231096	0	53	0	263	316
3R	19231097	0	115	0	200	315
3R	19231100	0	25	0	297	322
3R	19238197	0	102	0	162	264
3R	19238358	0	89	0	189	278
3R	19238845	0	68	0	141	209
3R	19389278	0	0	0	0	0
3R	19579291	0	0	1	0	1
3R	19637450	0	0	0	39	39
3R	19643921	0	29	0	0	29
3R	19653645	0	54	0	42	96
3R	19660641	0	0	3	0	3
3R	19662383	21	0	31	0	52
3R	19662407	0	0	52	0	52
3R	19734535	0	0	0	0	0
3R	19753763	44	0	108	0	152
3R	19753764	13	0	138	0	151
3R	19763634	29	0	174	0	203
3R	19765660	67	0	43	0	110
3R	19766576	0	0	134	0	134
3R	19836444	0	0	0	1	1
3R	19840656	0	0	0	0	0
3R	19847652	5	0	0	0	5
3R	19848089	1	0	1	0	2
3R	19848545	5	0	0	0	5
3R	19850222	80	0	97	0	177
3R	19901320	0	168	0	0	168
3R	19901682	0	0	0	159	159
3R	19914707	0	0	0	567	567
3R	19977151	0	0	0	0	0
3R	20037752	0	27	0	34	61
3R	20253305	6	0	1	0	7
3R	20253308	6	0	1	0	7
3R	20254800	0	0	0	0	0
3R	20322199	110	0	89	0	199
3R	20323426	0	0	126	0	126
3R	20397317	0	0	0	9	9
3R	20397347	0	0	0	8	8
3R	20397348	0	0	0	8	8
3R	20397350	0	0	0	8	8
3R	20397351	0	0	0	8	8
3R	20397356	0	0	0	8	8
3R	20397361	0	0	0	6	6
3R	20397362	0	0	0	7	7
3R	20397364	0	0	0	7	7
3R	20397502	0	0	0	5	5
3R	20397510	0	0	0	4	4
3R	20397511	0	0	0	4	4
3R	20397525	0	1	0	5	6
3R	20397526	0	2	0	4	6
3R	20397527	0	1	0	5	6
3R	20442288	0	0	0	4	4
3R	20538040	0	1	0	19	20
3R	20964328	1703	2	1035	1	2741
3R	20965039	1499	0	1060	1	2560
3R	20978916	82	0	15	0	97
3R	20986865	4	0	0	0	4
3R	20993738	55	0	211	0	266
3R	20993841	63	0	180	0	243
3R	20993853	122	0	133	0	255
3R	21010468	73	0	14	0	87
3R	21010472	73	0	14	0	87
3R	21018588	16	0	63	1	80
3R	21018593	62	0	11	0	73
3R	21018596	18	0	57	0	75
3R	21018660	38	0	53	0	91
3R	21018693	12	0	89	0	101
3R	21018789	76	2	5	0	83
3R	21020302	15	0	15	0	30
3R	21020304	25	0	5	0	30
3R	21020562	17	0	16	0	33
3R	21032796	0	1	0	3	4
3R	21034155	0	0	0	7	7
3R	21035203	0	0	0	2	2
3R	21035311	0	0	0	1	1
3R	21036317	0	0	0	4	4
3R	21210519	11	0	0	0	11
3R	21213783	85	0	16	0	101
3R	21216016	60	0	0	0	60
3R	21228047	8	0	42	0	50
3R	21228182	13	0	35	0	48
3R	21268995	0	0	0	211	211
3R	21275768	0	0	0	244	244
3R	21277235	0	8	0	4	12
3R	21297848	362	0	35	0	397
3R	21316786	0	0	0	2	2
3R	21337167	0	15	0	34	49
3R	21360556	0	0	0	0	0
3R	21580556	0	18	0	0	18
3R	21795674	0	1	0	0	1
3R	21866357	0	4	0	0	4
3R	21979019	0	0	0	2	2
3R	22782190	7	0	3	0	10
3R	22784953	22	0	13	0	35
3R	23061604	20	0	0	0	20
3R	23081390	0	0	0	617	617
3R	23092053	0	0	0	1	1
3R	23112549	0	0	0	583	583
3R	23124996	0	8	0	2	10
3R	23124998	0	0	0	10	10
3R	23125099	0	0	0	13	13
3R	23125127	0	0	0	12	12
3R	23125179	0	0	0	12	12
3R	23125191	0	8	0	5	13
3R	23180642	0	0	0	0	0
3R	23183620	0	0	35	0	35
3R	23188969	0	232	0	0	232
3R	23191853	0	145	0	1	146
3R	23200370	0	11	0	0	11
3R	23228940	0	171	0	0	171
3R	23229652	0	0	0	105	105
3R	23229765	0	0	0	134	134
3R	23245868	0	0	0	0	0
3R	23248865	0	0	0	38	38
3R	23252005	0	0	0	0	0
3R	23261644	0	6	0	2	8
3R	23348613	0	0	0	0	0
3R	23348619	0	0	0	0	0
3R	23348769	1	0	0	0	1
3R	23348836	1	0	0	0	1
3R	23349750	0	0	0	0	0
3R	23355233	0	0	0	11	11
3R	23379528	0	0	0	18	18
3R	23662171	0	0	0	0	0
3R	23662433	0	0	0	0	0
3R	23806927	0	0	0	32	32
3R	23807724	0	28	0	0	28
3R	23812871	0	0	0	112	112
3R	23847794	0	0	116	0	116
3R	23848537	69	0	58	0	127
3R	23889222	0	0	0	6	6
3R	23889403	0	0	0	4	4
3R	23903183	0	0	0	53	53
3R	23906410	0	0	0	0	0
3R	23913774	0	0	0	0	0
3R	23930726	0	139	0	0	139
3R	23936205	1	855	0	2	858
3R	23941852	0	3	0	0	3
3R	23954031	0	43	0	0	43
3R	23954205	0	42	0	0	42
3R	23954270	0	35	0	0	35
3R	23975656	0	0	9	0	9
3R	23976395	0	0	300	0	300
3R	23981667	72	0	29	0	101
3R	23982357	290	0	41	0	331
3R	23983504	347	0	67	0	414
3R	23999913	0	137	0	0	137
3R	24000236	0	171	0	0	171
3R	24000858	0	1	0	16	17
3R	24028532	0	0	0	0	0
3R	24028545	0	0	0	0	0
3R	24035862	0	85	0	0	85
3R	24038324	0	0	24	0	24
3R	24051777	0	0	107	0	107
3R	24059369	0	0	22	0	22
3R	24059405	0	0	26	0	26
3R	24063411	19	0	0	0	19
3R	24065016	0	29	0	0	29
3R	24079314	0	1	0	0	1
3R	24080205	0	0	0	0	0
3R	24080856	0	0	0	0	0
3R	24089901	0	1	0	0	1
3R	24094522	0	2	0	0	2
3R	24096044	0	5	0	0	5
3R	24103714	0	61	0	223	284
3R	24115231	0	138	0	0	138
3R	24136443	0	0	38	0	38
3R	24136633	0	0	19	0	19
3R	24136663	0	0	20	0	20
3R	24141432	0	0	21	0	21
3R	24157937	0	50	0	0	50
3R	24162927	0	16	0	1	17
3R	24214769	0	3	0	0	3
3R	24228774	0	5	0	0	5
3R	24235203	0	0	0	0	0
3R	24292106	43	0	0	0	43
3R	24308629	46	0	29	0	75
3R	24309492	54	0	23	0	77
3R	24311331	34	0	32	0	66
3R	24399715	39	0	0	0	39
3R	24401818	0	30	0	34	64
3R	24511651	0	32	0	76	108
3R	24511656	0	37	0	70	107
3R	24512020	0	1	0	11	12
3R	24512901	0	7	0	18	25
3R	24512911	0	9	0	19	28
3R	24600699	0	0	0	0	0
3R	24668815	38	0	4	0	42
3R	24674513	169	0	21	0	190
3R	24675475	34	0	3	0	37
3R	24675663	13	0	99	0	112
3R	24690643	17	0	2	0	19
3R	24691493	161	0	18	0	179
3R	24692577	3	0	8	0	11
3R	24697793	19	0	4	0	23
3R	24706551	38	0	238	0	276
3R	24707423	49	0	162	0	211
3R	24707696	197	0	68	1	266
3R	24707890	248	0	47	0	295
3R	24708326	130	0	38	0	168
3R	24708329	125	0	46	0	171
3R	24708330	108	0	53	0	161
3R	24708356	148	0	25	0	173
3R	24829203	0	0	0	73	73
3R	25026672	29	0	0	0	29
3R	25039627	201	0	0	0	201
3R	25134628	2	0	2	0	4
3R	25136056	56	0	0	0	56
3R	25268354	1	0	1	0	2
3R	25346655	0	13	0	89	102
3R	25516393	0	0	0	0	0
3R	25530500	0	0	0	0	0
3R	25607422	0	0	0	15	15
3R	25680862	74	0	0	0	74
3R	25871448	44	0	1	0	45
3R	25871506	44	0	0	0	44
3R	25871531	41	0	0	0	41
3R	25871712	41	0	0	0	41
3R	25871911	43	0	0	0	43
3R	25965631	271	0	83	0	354
3R	25965643	1	0	354	0	355
3R	26275388	35	0	2	0	37
3R	26344955	0	0	0	0	0
3R	26384361	0	0	0	0	0
3R	26533202	0	3	0	1	4
3R	26533203	0	0	0	3	3
3R	26533204	0	0	0	4	4
3R	26533205	0	0	0	4	4
3R	26544601	0	0	0	0	0
3R	26555239	72	0	23	0	95
3R	26572578	1	0	0	0	1
3R	26593045	7	0	3	0	10
3R	26601314	0	0	82	0	82
3R	26681389	0	0	0	59	59
3R	26698436	0	0	0	224	224
3R	26699744	0	130	0	256	386
3R	26703453	0	0	0	5	5
3R	26706990	0	0	0	0	0
3R	26707060	0	0	0	0	0
3R	26710227	0	0	0	0	0
3R	26710639	0	0	0	0	0
3R	26711278	0	0	0	1	1
3R	26711482	0	0	0	1	1
3R	26722743	0	0	0	50	50
3R	26799601	2	0	0	0	2
3R	26803090	0	0	0	0	0
3R	26839293	0	0	68	0	68
3R	26839692	83	0	0	0	83
3R	26854725	0	0	0	0	0
3R	26869981	0	0	0	668	668
3R	26870035	0	1	0	715	716
3R	26898498	0	0	0	0	0
3R	26922349	2	0	0	0	2
3R	26941648	105	0	0	0	105
3R	26942517	1	0	129	0	130
3R	26950965	0	0	0	339	339
3R	26964540	0	5	0	0	5
3R	26971309	41	0	0	0	41
3R	27006713	0	0	0	0	0
3R	27059393	0	0	0	2	2
3R	27065920	0	0	0	61	61
3R	27065932	0	0	0	57	57
3R	27101403	0	0	0	14	14
3R	27155499	287	0	0	0	287
3R	27159080	74	0	0	0	74
3R	27237462	0	0	0	75	75
3R	27255644	104	0	0	0	104
3R	27260195	0	0	0	59	59
3R	27275221	3	0	0	0	3
3R	27436670	0	0	0	22	22
3R	27581330	0	0	0	2	2
3R	27610850	0	0	0	0	0
3R	27643914	0	25	0	255	280
3R	27669340	118	0	50	0	168
3R	27673172	135	0	107	0	242
3R	27673289	51	0	199	0	250
3R	27674209	151	0	0	0	151
3R	27674284	170	0	0	0	170
3R	27674568	93	0	161	0	254
3R	27674719	205	0	74	0	279
3R	27674736	26	0	259	0	285
3R	27674878	60	0	211	0	271
3R	27674907	113	0	175	0	288
3R	27675074	271	0	109	1	381
3R	27676160	265	0	85	0	350
3R	27676232	143	0	117	0	260
3R	27923909	1	0	0	0	1
3R	27928133	0	2	0	0	2
3R	27949844	0	0	101	0	101
3R	27954914	0	2	0	0	2
3R	27955650	0	0	12	0	12
3R	27956797	0	0	17	0	17
3R	27957947	0	21	0	1	22
3R	27965771	0	0	18	0	18
3R	27965792	0	0	20	0	20
3R	27966580	0	0	18	0	18
3R	27987451	0	0	0	0	0
3R	28077291	1	0	0	0	1
3R	28211257	0	0	0	0	0
3R	28418412	79	0	0	0	79
3R	28598794	0	16	0	31	47
3R	28630348	0	0	0	1	1
3R	28740661	0	0	0	0	0
3R	28755588	0	0	0	0	0
3R	28755612	0	0	0	0	0
3R	28824334	16	0	0	0	16
3R	28825660	0	101	0	0	101
3R	28834732	0	73	0	0	73
3R	28841035	0	0	0	0	0
3R	28842883	0	1	0	0	1
3R	28845314	0	11	0	0	11
3R	28845906	0	0	30	0	30
3R	28874903	57	0	0	0	57
3R	28877734	0	0	0	4	4
3R	28883203	0	0	0	0	0
3R	28893176	0	0	24	0	24
3R	28903133	16	0	0	0	16
3R	28910138	43	0	0	0	43
3R	28925501	0	0	0	48	48
3R	29682986	2	0	1	0	3
3R	29725169	0	0	39	0	39
3R	29809019	0	0	12	0	12
3R	29852709	54	0	0	0	54
3R	29877130	83	0	0	0	83
3R	29877330	117	0	0	0	117
3R	29877364	116	0	0	0	116
3R	29990367	9	0	0	0	9
3R	29991674	0	0	0	18	18
3R	30002686	0	0	0	96	96
3R	30012340	0	0	0	7	7
3R	30012471	0	0	0	12	12
3R	30014618	0	0	0	13	13
3R	30036766	0	0	0	8	8
3R	30040555	29	0	0	0	29
3R	30083131	5	0	0	0	5
3R	30092365	8	0	0	0	8
3R	30103150	24	0	0	0	24
3R	30104256	194	0	0	0	194
3R	30112301	0	0	223	0	223
3R	30113784	61	0	0	0	61
3R	30114780	29	0	0	0	29
3R	30115158	18	0	0	0	18
3R	30199030	0	0	0	0	0
3R	30303048	1	0	0	0	1
3R	30420927	0	0	0	92	92
3R	30774448	24	0	0	0	24
3R	30796901	0	0	0	0	0
3R	31046504	17	0	1	0	18
3R	31160434	4	0	0	0	4
3R	31228686	87	0	15	0	102
3R	31597431	0	69	0	247	316
3R	31597432	0	108	0	206	314
3R	31599016	0	81	0	707	788
3R	31601718	0	178	0	391	569
3R	31601828	0	153	0	756	909
3R	31602191	0	216	0	1013	1229
3R	31608331	0	5	0	12	17
3R	31724907	0	0	0	0	0
3R	31837086	28	0	32	0	60
3R	31837089	22	0	38	0	60
3R	31844215	47	0	23	0	70
3R	31844748	88	1	23	0	112
4	55144	0	0	0	3	3
4	76506	0	0	0	0	0
4	86500	1	0	0	0	1
4	100011	50	0	1	0	51
4	100035	11	0	33	0	44
4	100181	2	0	22	0	24
4	100197	15	0	9	0	24
4	100200	21	0	4	0	25
4	100204	15	0	9	0	24
4	100214	23	0	3	0	26
4	100219	14	0	3	3	20
4	100289	44	0	8	0	52
4	100442	73	0	2	0	75
4	100530	65	0	4	0	69
4	100539	62	0	3	0	65
4	100543	38	0	29	0	67
4	100547	64	0	3	0	67
4	100549	30	0	35	0	65
4	100554	35	0	26	0	61
4	100556	59	0	0	0	59
4	100557	40	0	18	0	58
4	100558	47	0	12	0	59
4	100559	40	0	19	0	59
4	100560	8	0	48	0	56
4	100563	2	0	55	0	57
4	100629	34	0	14	0	48
4	101660	15	0	72	0	87
4	102327	41	0	46	0	87
4	102349	33	0	48	0	81
4	113007	113	0	75	0	188
4	126831	0	2	0	1	3
4	126842	0	2	0	1	3
4	128747	0	0	0	2	2
4	182444	1	1	0	3	5
4	182525	0	0	0	1	1
4	191689	0	11	0	6	17
4	191704	0	14	0	7	21
4	191708	0	13	0	9	22
4	192653	0	5	0	19	24
4	192661	0	16	0	5	21
4	192670	0	17	0	9	26
4	192672	0	2	0	24	26
4	192677	0	15	0	11	26
4	192684	0	12	0	17	29
4	192692	0	11	0	19	30
4	192715	0	12	0	16	28
4	192723	0	8	0	20	28
4	192724	0	8	0	20	28
4	213353	18	0	29	0	47
4	213371	38	0	15	0	53
4	214241	19	0	13	0	32
4	234621	1	0	3	0	4
4	234717	3	0	1	0	4
4	234747	0	0	5	0	5
4	234775	4	0	0	0	4
4	234798	5	0	0	0	5
4	235270	2	0	0	0	2
4	235273	1	0	1	0	2
4	235277	2	0	0	0	2
4	235278	2	0	0	0	2
4	235280	1	0	0	0	1
4	235284	2	0	0	0	2
4	235287	1	0	0	0	1
4	235308	1	0	0	0	1
4	235309	1	0	0	0	1
4	235310	1	0	0	0	1
4	235311	1	0	0	0	1
4	235313	1	0	0	0	1
4	235317	1	0	0	0	1
4	235319	1	0	0	0	1
4	235336	1	0	0	0	1
4	235338	1	0	0	0	1
4	235343	1	0	0	0	1
4	235344	1	0	0	0	1
4	235495	1	0	1	0	2
4	235496	1	0	2	0	3
4	235506	2	0	1	0	3
4	265270	21	0	0	0	21
4	265273	23	0	0	0	23
4	292019	0	1	0	0	1
4	292441	0	1	0	2	3
4	294654	0	2	0	1	3
4	295725	0	0	0	4	4
4	304161	0	1	0	0	1
4	328580	0	9	0	7	16
4	339075	0	11	0	20	31
4	340376	0	16	0	11	27
4	340381	0	6	0	19	25
4	340398	0	7	0	19	26
4	341198	0	1	0	13	14
4	341200	0	1	0	13	14
4	343860	0	0	0	1	1
4	351351	0	0	0	3	3
4	351417	0	0	0	6	6
4	356697	0	1	0	0	1
4	356702	0	1	0	0	1
4	356711	0	1	0	0	1
4	356722	0	1	0	0	1
4	356723	0	1	0	0	1
4	356726	0	0	0	1	1
4	356734	0	1	0	0	1
4	356773	0	1	0	0	1
4	357621	0	1	0	1	2
4	357626	0	1	0	1	2
4	357672	0	1	0	1	2
4	357673	0	1	0	1	2
4	367899	11	0	1	0	12
4	403085	1	0	0	0	1
4	446514	119	0	25	0	144
4	446530	126	0	18	0	144
4	448154	35	0	4	0	39
4	448773	33	0	12	0	45
4	449601	91	0	7	0	98
4	449602	81	0	14	0	95
4	449672	75	0	7	0	82
4	449705	76	0	8	0	84
4	449711	77	0	7	0	84
4	449740	72	0	9	0	81
4	449751	62	0	13	0	75
4	449767	51	0	17	0	68
4	454069	93	0	4	0	97
4	454073	104	0	1	0	105
4	454076	95	0	6	0	101
4	454085	85	0	17	0	102
4	455119	3	0	6	0	9
4	455123	7	0	4	0	11
4	455582	11	0	1	0	12
4	455778	14	0	3	0	17
4	459603	11	0	0	0	11
4	459637	8	0	0	0	8
4	476665	0	11	0	15	26
4	476688	0	19	0	5	24
4	476701	0	7	0	11	18
4	476921	0	12	0	7	19
4	520535	1	0	0	0	1
4	541492	0	8	0	21	29
4	541536	0	23	0	12	35
4	541538	0	11	0	24	35
4	541539	0	28	0	6	34
4	541545	0	12	0	23	35
4	541585	0	9	0	25	34
4	541776	0	13	0	27	40
4	541778	0	26	0	13	39
4	541780	0	0	0	39	39
4	541782	0	24	0	13	37
4	541784	0	25	0	12	37
4	541793	36	0	0	0	36
4	541795	0	4	0	37	41
4	541819	0	2	0	36	38
4	541822	0	3	0	35	38
4	541825	0	3	0	37	40
4	541826	0	4	0	36	40
4	541828	0	2	0	34	36
4	541882	0	3	0	31	34
4	541884	0	0	0	39	39
4	541886	0	8	0	30	38
4	541887	0	4	0	34	38
4	541889	0	5	0	33	38
4	541890	0	2	0	36	38
4	560912	42	0	4	0	46
4	560934	30	0	15	0	45
4	561097	36	0	12	0	48
4	563220	10	0	1	0	11
4	563252	9	0	2	0	11
4	563258	8	0	1	0	9
4	563274	7	0	2	0	9
4	563284	8	0	1	0	9
4	563291	1	0	0	0	1
4	563330	2	0	0	0	2
4	563333	1	0	1	0	2
4	563340	3	0	0	0	3
4	563347	2	0	1	0	3
4	563352	1	0	2	0	3
4	563354	2	0	1	0	3
4	563367	1	0	2	0	3
4	563368	0	0	3	0	3
4	563369	3	0	0	0	3
4	563370	0	0	3	0	3
4	563373	1	0	2	0	3
4	563377	3	0	1	0	4
4	563380	2	0	2	0	4
4	563383	2	0	2	0	4
4	563384	0	0	4	0	4
4	563385	0	0	4	0	4
4	563386	4	0	0	0	4
4	563390	2	0	3	0	5
4	563396	4	0	1	0	5
4	563398	1	0	3	0	4
4	563399	1	0	5	0	6
4	563401	5	0	0	0	5
4	563402	2	0	3	0	5
4	563403	1	0	5	0	6
4	563405	3	0	3	0	6
4	563409	5	0	2	0	7
4	563414	1	0	6	0	7
4	563416	6	0	0	0	6
4	563537	16	0	0	0	16
4	579932	10	0	0	0	10
4	579972	8	0	0	0	8
4	579974	8	0	0	0	8
4	579978	7	0	0	0	7
4	579980	8	0	0	0	8
4	602510	0	5	0	8	13
4	612525	8	0	0	0	8
4	636945	0	4	0	2	6
4	638429	0	0	0	11	11
4	653771	0	0	0	0	0
4	654895	0	8	0	14	22
4	654898	0	6	0	16	22
4	659412	0	1	0	34	35
4	667083	23	0	3	0	26
4	667084	23	0	4	0	27
4	667085	23	0	3	0	26
4	667101	14	0	9	0	23
4	667104	17	0	9	0	26
4	668200	22	0	5	0	27
4	668202	16	0	12	0	28
4	686912	66	0	21	0	87
4	686921	66	0	16	0	82
4	686924	52	0	30	0	82
4	686926	74	0	10	0	84
4	686929	36	0	47	0	83
4	686932	33	0	47	0	80
4	686941	76	0	4	0	80
4	686958	58	0	12	1	71
4	686973	65	0	9	0	74
4	686981	71	0	6	0	77
4	687294	21	0	29	0	50
4	688162	66	0	11	0	77
4	725144	0	0	0	0	0
4	743070	50	0	2	0	52
4	744196	2	0	0	0	2
4	744197	2	0	0	0	2
4	744213	2	0	0	0	2
4	744215	2	0	0	0	2
4	744797	3	0	0	0	3
4	744886	2	0	0	0	2
4	744897	2	0	0	0	2
4	745047	1	0	0	0	1
4	745107	1	0	0	0	1
4	747687	49	0	0	1	50
4	747738	37	0	15	0	52
4	767187	194	0	5	0	199
4	767264	165	0	14	0	179
4	823281	0	1	0	0	1
4	856273	0	0	0	19	19
4	856282	0	5	0	13	18
4	856311	0	13	0	3	16
4	856324	0	0	0	17	17
4	856326	0	6	0	10	16
4	856328	0	5	0	12	17
4	856331	0	1	0	15	16
4	856359	0	12	0	2	14
4	856373	0	6	0	7	13
4	857770	0	12	0	3	15
4	858835	0	7	0	3	10
4	858841	0	4	0	8	12
4	860159	0	3	0	9	12
4	860173	0	3	0	7	10
4	860227	0	7	0	4	11
4	860232	0	3	0	8	11
4	860236	0	2	0	8	10
4	874383	0	243	0	142	385
4	878970	1	133	0	292	426
4	879448	0	7	0	59	66
4	879496	0	45	0	14	59
4	879936	0	3	0	86	89
4	882370	0	43	0	77	120
4	889066	0	63	0	23	86
4	895648	0	1	0	0	1
4	896129	0	0	0	0	0
4	896139	0	0	0	0	0
4	896192	0	0	0	1	1
4	897223	0	1	0	1	2
4	897246	0	0	0	2	2
4	897262	0	0	0	2	2
4	897309	0	1	0	1	2
4	908982	0	4	0	11	15
4	980493	0	0	0	0	0
4	980622	0	0	0	0	0
4	999228	16	0	4	0	20
4	1039524	0	4	0	74	78
4	1039649	0	8	0	63	71
4	1040392	0	3	0	103	106
4	1040397	0	21	0	88	109
4	1041214	0	99	0	73	172
4	1041225	0	107	0	97	204
4	1041307	0	125	0	66	191
4	1041381	0	33	0	170	203
4	1041388	0	42	0	160	202
4	1041389	0	19	0	183	202
4	1041395	0	44	0	157	201
4	1041418	0	22	0	181	203
4	1041449	0	27	0	177	204
4	1041451	0	106	0	88	194
4	1041452	0	36	0	164	200
4	1041464	0	5	0	190	195
4	1041465	0	22	0	170	192
4	1041478	0	59	0	110	169
4	1041482	0	34	0	136	170
4	1041483	0	11	0	160	171
4	1041494	0	82	0	81	163
4	1041500	0	16	0	150	166
4	1041514	0	33	0	134	167
4	1041521	0	21	0	144	165
4	1041544	0	36	0	125	161
4	1042206	0	43	0	132	175
4	1042231	0	21	0	158	179
4	1042257	0	33	0	143	176
4	1042367	0	19	0	207	226
4	1042368	0	33	0	194	227
4	1042371	0	99	0	126	225
4	1042502	0	73	0	123	196
4	1042610	0	96	0	104	200
4	1042667	0	40	0	179	219
4	1042794	0	12	0	197	209
4	1042907	0	29	0	125	154
4	1042971	0	13	0	129	142
4	1042975	0	28	0	114	142
4	1045395	0	0	0	0	0
4	1045396	0	0	0	0	0
4	1046984	0	2	0	5	7
4	1046986	0	0	0	7	7
4	1046987	0	0	0	7	7
4	1051636	0	13	0	12	25
4	1052332	0	1	0	4	5
4	1125511	1	0	1	0	2
4	1125515	2	0	0	0	2
4	1125529	1	0	1	0	2
4	1125587	1	0	1	0	2
4	1125632	2	0	0	0	2
4	1126049	0	0	0	0	0
4	1126064	0	0	0	0	0
4	1126065	0	0	0	0	0
4	1126078	0	0	0	0	0
4	1126349	3	0	0	0	3
4	1132912	17	0	14	0	31
4	1132913	28	0	3	0	31
4	1132915	6	0	25	0	31
4	1132917	28	0	4	0	32
4	1132932	30	0	8	0	38
4	1132946	10	0	30	0	40
4	1133654	9	0	37	0	46
4	1133655	27	0	19	0	46
4	1134443	135	0	43	0	178
4	1134452	145	0	21	0	166
4	1134469	119	1	55	0	175
4	1134830	92	0	20	0	112
4	1134861	22	0	81	0	103
4	1134869	83	0	23	0	106
4	1136039	20	0	6	0	26
4	1136068	26	0	1	0	27
4	1137308	2	0	18	0	20
4	1148236	1	0	0	0	1
4	1148466	1	0	3	0	4
4	1168877	10	0	14	0	24
4	1232612	13	0	0	0	13
4	1232942	3	0	5	0	8
4	1234422	6	0	1	0	7
4	1234429	4	0	2	0	6
4	1244706	3	0	12	0	15
4	1244726	11	0	4	0	15
4	1244727	8	0	6	0	14
4	1252829	13	0	38	0	51
4	1252993	39	0	4	0	43
4	1254576	26	0	7	0	33
4	1255125	30	0	5	0	35
4	1255131	21	0	15	0	36
4	1255132	27	0	7	0	34
4	1255154	32	0	7	0	39
4	1255163	39	0	4	0	43
4	1255168	34	0	9	0	43
4	1257070	29	0	12	0	41
4	1257336	23	0	4	0	27
4	1257543	17	0	10	0	27
4	1257984	33	0	8	0	41
4	1260280	5	0	27	0	32
4	1260284	23	0	14	0	37
4	1265107	142	0	190	0	332
4	1267648	3	0	0	0	3
Un_DS483999v1	2471	0	0	0	0	0
Un_DS484083v1	1024	0	0	0	0	0
Un_DS484090v1	1859	0	0	0	0	0
Un_DS484176v1	2586	0	0	0	0	0
Un_DS484511v1	1204	0	0	0	0	0
Un_DS484539v1	1135	0	0	0	0	0
Un_DS484746v1	578	0	0	0	0	0
Un_DS485536v1	813	0	0	0	0	0
Un_DS485605v1	551	0	0	0	0	0
X	514252	0	37	0	62	99
X	514297	0	20	0	83	103
X	514298	0	22	0	85	107
X	516944	0	14	0	52	66
X	516949	0	9	0	54	63
X	516964	0	14	0	46	60
X	923306	0	0	0	92	92
X	923307	0	0	0	88	88
X	924277	0	71	0	40	111
X	1373346	159	1	96	0	256
X	1373528	97	0	106	0	203
X	1373589	127	0	47	0	174
X	1373602	148	0	38	0	186
X	1378095	203	0	67	0	270
X	1378279	135	0	115	0	250
X	1378284	110	0	144	0	254
X	1491577	0	28	0	26	54
X	1676057	0	108	0	11	119
X	1676066	1	39	0	79	119
X	1676597	0	157	0	35	192
X	1690573	0	65	0	125	190
X	1781840	64	0	66	0	130
X	1784005	59	0	52	0	111
X	1784034	70	0	39	0	109
X	1784035	85	0	22	0	107
X	1784036	61	0	45	0	106
X	1785204	129	0	6	0	135
X	1785212	128	0	10	0	138
X	1785216	114	0	25	0	139
X	1785256	110	0	0	0	110
X	1785441	112	0	7	0	119
X	1785444	119	0	5	0	124
X	1785543	120	0	10	0	130
X	1785888	37	0	52	0	89
X	1785903	79	0	8	0	87
X	1786528	135	0	2	0	137
X	1854163	0	0	0	0	0
X	1854164	0	0	0	0	0
X	2078771	0	0	0	65	65
X	2112342	146	0	60	0	206
X	2112355	177	0	33	0	210
X	2112356	132	0	80	0	212
X	2180389	0	0	0	0	0
X	2219688	0	10	0	6	16
X	2376647	0	18	0	15	33
X	2434676	0	2	0	4	6
X	2515228	0	0	0	6	6
X	2625116	3	0	0	0	3
X	2628866	72	0	129	0	201
X	2660761	172	0	0	0	172
X	2667642	0	0	1	0	1
X	2677613	193	0	7	0	200
X	2678338	111	0	9	0	120
X	2678342	89	0	26	0	115
X	3297989	2	0	1	0	3
X	3342781	8	0	6	0	14
X	3343393	41	0	1	0	42
X	3477696	0	0	0	74	74
X	3719089	0	0	0	1	1
X	3730329	0	0	0	0	0
X	3859628	1	418	0	1955	2374
X	3859645	0	564	0	1766	2330
X	3860640	0	350	0	2156	2506
X	3860692	0	338	0	2278	2616
X	3860693	0	1225	0	1363	2588
X	3860694	0	266	1	2356	2623
X	3861312	7	199	0	1554	1760
X	3861498	1	468	3	1673	2145
X	3861499	0	427	2	1641	2070
X	3861500	1	255	1	1910	2167
X	3861501	2	1805	0	278	2085
X	3861505	1	1507	0	558	2066
X	3895378	0	2	0	60	62
X	3953264	225	0	106	0	331
X	4102802	0	0	0	0	0
X	4217290	0	0	0	0	0
X	4352383	2	0	1	0	3
X	4356397	67	0	5	0	72
X	4689184	0	0	1	0	1
X	4689563	0	0	0	0	0
X	4701126	0	1	0	325	326
X	4711852	0	0	0	0	0
X	4981377	0	0	0	0	0
X	5087477	7	0	7	0	14
X	5170349	22	0	5	0	27
X	5239523	64	0	15	0	79
X	5251934	0	0	0	120	120
X	5252342	52	0	36	0	88
X	5360710	1	0	1	0	2
X	5396519	76	0	44	0	120
X	5397332	8	0	14	0	22
X	5397347	17	0	5	0	22
X	5397612	11	0	1	0	12
X	5630114	0	514	0	89	603
X	5630195	1	75	1	577	654
X	5630213	0	331	0	344	675
X	5630234	1	501	0	125	627
X	5630342	0	305	0	279	584
X	5630737	0	54	7	456	517
X	5631026	0	210	0	177	387
X	5631035	0	320	0	49	369
X	5631048	0	345	0	72	417
X	5788690	0	0	17	0	17
X	5810061	0	0	0	0	0
X	5963943	0	0	0	0	0
X	5998043	0	1	0	26	27
X	6105139	0	2	0	108	110
X	6107611	1	120	1	286	408
X	6107620	0	243	0	160	403
X	6107716	0	103	0	38	141
X	6108552	0	260	0	63	323
X	6108553	0	303	0	14	317
X	6108712	0	175	2	2	179
X	6108766	0	72	0	145	217
X	6109871	0	52	0	211	263
X	6112645	0	18	0	177	195
X	6115425	0	191	0	23	214
X	6145386	0	19	0	138	157
X	6184321	0	0	0	0	0
X	6531547	0	0	0	0	0
X	6537186	0	0	7	0	7
X	6577785	9	0	0	0	9
X	6790259	0	3	0	10	13
X	7085816	0	115	0	34	149
X	7445827	12	0	6	0	18
X	7698223	0	0	0	1	1
X	7912801	55	0	0	0	55
X	7938121	0	0	0	0	0
X	7987553	0	0	0	0	0
X	8046474	0	0	0	9	9
X	8055921	0	0	0	0	0
X	8055924	0	0	0	0	0
X	8240090	49	0	80	0	129
X	8240161	90	0	38	0	128
X	8247628	217	0	131	1	349
X	8272518	0	1	0	2	3
X	8403319	11	0	24	0	35
X	8409426	0	0	0	24	24
X	8518112	10	0	2	0	12
X	8632440	0	17	0	29	46
X	8649283	0	0	0	0	0
X	8908884	0	3	0	1	4
X	8910271	0	4	0	0	4
X	8917312	6	0	0	0	6
X	8927652	1	0	0	0	1
X	8927665	1	0	0	0	1
X	8941468	2	0	1	0	3
X	8942088	4	0	0	0	4
X	8942812	1	0	1	0	2
X	8966417	6	0	2	0	8
X	9002119	0	0	0	0	0
X	9020223	21	0	56	0	77
X	9020239	36	0	45	0	81
X	9020384	4	0	55	0	59
X	9022297	0	0	0	91	91
X	9022830	91	0	11	0	102
X	9022835	20	0	73	0	93
X	9022869	16	0	60	1	77
X	9022902	74	0	3	1	78
X	9022931	64	0	50	0	114
X	9022942	70	0	42	0	112
X	9022943	99	0	16	0	115
X	9028080	153	0	86	0	239
X	9028091	134	0	94	0	228
X	9037319	0	0	0	0	0
X	9153487	0	227	0	1619	1846
X	9200948	0	0	0	1	1
X	9278576	0	12	0	17	29
X	9340169	0	0	0	0	0
X	9574655	0	63	0	23	86
X	9754490	2	0	11	0	13
X	10016995	0	0	0	1	1
X	10247964	0	3	0	30	33
X	10330625	0	0	0	0	0
X	10356486	219	0	0	0	219
X	10463690	69	0	0	0	69
X	10639732	0	0	0	0	0
X	10709480	65	0	10	0	75
X	10711327	0	0	0	30	30
X	10711351	0	0	0	30	30
X	10746485	117	0	44	0	161
X	10746488	110	0	49	0	159
X	10817179	0	0	0	0	0
X	10835849	0	58	0	36	94
X	10846781	0	57	0	56	113
X	11047667	9	0	1	0	10
X	11047679	6	0	2	0	8
X	11047750	6	0	10	0	16
X	11047753	7	0	11	0	18
X	11048103	8	0	14	0	22
X	11052798	0	184	0	122	306
X	11221249	0	1	0	28	29
X	11221253	0	2	0	26	28
X	11221255	1	1	0	26	28
X	11221259	0	3	0	25	28
X	11221261	0	0	0	28	28
X	11221263	0	1	0	28	29
X	11221265	0	0	0	30	30
X	11221267	0	0	0	30	30
X	11221296	0	1	0	34	35
X	11221308	0	1	0	34	35
X	11221310	0	0	0	35	35
X	11221312	0	0	0	35	35
X	11221318	0	2	0	28	30
X	11221322	0	1	0	30	31
X	11221325	0	3	0	27	30
X	11224387	0	36	0	33	69
X	11330935	73	0	0	0	73
X	11371626	6	0	0	0	6
X	11553315	102	0	0	0	102
X	11575555	10	0	16	0	26
X	11704179	117	0	31	0	148
X	11704188	80	0	57	0	137
X	11812074	0	68	0	50	118
X	11812089	0	78	1	43	122
X	11939698	0	53	0	68	121
X	11939764	0	38	0	78	116
X	11949882	0	69	0	57	126
X	11949883	0	35	0	91	126
X	11954277	0	91	0	22	113
X	11955525	0	11	0	4	15
X	11955561	0	15	0	6	21
X	11964192	0	13	0	88	101
X	11967712	0	19	0	17	36
X	11968032	0	16	0	12	28
X	11968676	0	5	0	89	94
X	11968768	0	64	0	31	95
X	11968969	0	23	0	60	83
X	11970546	1	18	0	67	86
X	11970552	0	5	0	71	76
X	11970556	0	31	0	52	83
X	11971853	0	62	0	28	90
X	11977538	0	55	0	9	64
X	12178407	0	0	0	0	0
X	12234654	2	0	0	1	3
X	12321994	0	0	142	0	142
X	12411368	0	0	0	0	0
X	12446818	25	0	3	0	28
X	12517682	0	18	0	48	66
X	12517716	0	10	0	56	66
X	12530707	0	0	0	0	0
X	12570094	0	15	0	12	27
X	12570147	0	23	0	5	28
X	12610058	0	4	0	62	66
X	12633103	6	0	7	0	13
X	12638680	336	0	53	0	389
X	12670776	1	0	0	0	1
X	12772709	16	0	13	0	29
X	12779207	0	3	0	8	11
X	12836423	0	0	0	0	0
X	12920895	8	1	1	0	10
X	13075382	37	0	75	0	112
X	13326657	0	0	57	0	57
X	13338794	37	0	0	0	37
X	13363027	0	0	0	0	0
X	13363147	1	0	7	0	8
X	13364994	35	0	10	0	45
X	13375332	0	0	0	0	0
X	13713539	50	0	15	0	65
X	13713540	46	0	15	1	62
X	13713557	55	0	9	0	64
X	13713560	54	0	7	0	61
X	13713989	26	0	11	0	37
X	13714028	47	0	4	0	51
X	13714030	42	0	11	0	53
X	13714099	54	0	1	0	55
X	13714108	50	0	6	0	56
X	13915030	0	0	0	0	0
X	13960364	0	0	0	0	0
X	13981405	0	0	0	0	0
X	13988603	0	4	0	10	14
X	14017285	0	0	0	0	0
X	14272086	76	0	15	0	91
X	14272092	5	0	86	0	91
X	14272096	1	0	89	0	90
X	14274268	63	0	30	0	93
X	14791453	0	23	0	93	116
X	14803625	0	0	0	0	0
X	14827027	0	15	1	52	68
X	14827028	0	31	0	40	71
X	14827029	0	31	0	39	70
X	14904567	730	0	0	0	730
X	14932507	39	0	20	0	59
X	14996674	29	0	26	0	55
X	14999166	6	0	6	0	12
X	14999641	6	0	7	0	13
X	14999868	11	0	52	0	63
X	14999920	73	0	13	0	86
X	14999924	9	0	75	0	84
X	14999938	71	0	5	0	76
X	15000623	22	0	61	0	83
X	15002265	14	0	26	0	40
X	15004413	23	0	73	0	96
X	15004776	23	0	50	0	73
X	15004857	24	0	77	0	101
X	15004878	71	0	24	0	95
X	15043300	0	0	0	0	0
X	15058391	0	32	0	12	44
X	15098493	69	0	57	0	126
X	15098592	58	0	82	0	140
X	15111879	30	0	82	0	112
X	15112038	69	0	0	0	69
X	15304670	2	0	0	0	2
X	15388627	0	12	0	49	61
X	15392685	0	144	0	25	169
X	15483634	31	0	1	0	32
X	15484167	20	0	1	0	21
X	15501741	0	0	0	0	0
X	15531613	0	0	0	0	0
X	15581889	0	27	0	0	27
X	15897294	346	0	310	0	656
X	15897759	26	0	17	0	43
X	15897789	44	0	3	0	47
X	15897854	32	0	10	0	42
X	15897856	37	0	7	0	44
X	15903965	13	2	138	0	153
X	15919889	117	0	13	1	131
X	15952334	0	6	0	21	27
X	15956689	0	6	0	36	42
X	15956841	0	1	0	45	46
X	15958587	0	130	0	10	140
X	15961105	0	2	0	13	15
X	15961636	0	3	0	24	27
X	15989371	0	6	0	49	55
X	16075853	0	1	0	56	57
X	16339624	53	0	63	0	116
X	16339799	71	0	13	0	84
X	16456420	0	3	0	44	47
X	16456425	0	15	0	38	53
X	16460238	0	15	0	96	111
X	16460589	0	11	0	127	138
X	16460590	0	4	0	135	139
X	16460595	0	17	0	121	138
X	16464719	0	108	0	11	119
X	16466198	0	28	0	29	57
X	16466199	0	47	0	9	56
X	16466203	0	10	0	44	54
X	16466204	0	9	0	45	54
X	16466216	0	2	0	49	51
X	16466692	0	0	0	112	112
X	16468562	0	61	0	2	63
X	16469630	0	20	0	33	53
X	16469631	0	29	0	23	52
X	16471229	0	53	0	43	96
X	16471265	0	46	0	66	112
X	16471290	0	18	0	88	106
X	16471319	0	40	0	60	100
X	16471811	0	17	0	16	33
X	16471812	0	12	0	20	32
X	16471813	0	13	0	19	32
X	16471814	0	8	0	21	29
X	16473609	0	7	0	77	84
X	16473610	0	5	0	78	83
X	16473637	0	42	0	33	75
X	16473638	0	6	0	66	72
X	16475638	0	18	0	80	98
X	16475685	0	5	0	96	101
X	16477558	0	7	0	72	79
X	16481881	0	1	0	23	24
X	16482682	0	46	0	58	104
X	16482683	0	24	0	79	103
X	16482692	0	6	0	101	107
X	16482693	0	56	0	50	106
X	16504240	0	62	0	65	127
X	16504273	0	0	0	148	148
X	16505310	0	0	0	22	22
X	16505550	0	109	0	32	141
X	16509658	0	18	0	109	127
X	16509671	0	10	0	120	130
X	16509684	0	23	0	106	129
X	16511854	0	3	0	17	20
X	16514487	0	0	0	21	21
X	16517164	0	11	0	16	27
X	16518833	0	73	0	26	99
X	16523520	0	0	0	0	0
X	16523529	0	0	0	0	0
X	16523541	0	0	0	0	0
X	16523553	0	0	0	0	0
X	16523556	0	0	0	0	0
X	16523557	0	0	0	0	0
X	16532860	0	2	0	3	5
X	16532866	0	1	0	3	4
X	16562027	0	19	0	95	114
X	16562108	0	30	0	100	130
X	16681534	0	5	0	23	28
X	16839820	0	14	0	56	70
X	16839947	0	1	0	59	60
X	16905030	0	0	0	2	2
X	16915290	6	0	0	0	6
X	17016883	0	2	0	5	7
X	17016898	0	0	0	8	8
X	17017015	0	3	0	0	3
X	17027613	0	0	0	0	0
X	17082644	0	0	0	0	0
X	17097065	58	0	4	0	62
X	17291667	0	0	0	1	1
X	17666685	561	0	0	0	561
X	17674476	0	3	0	11	14
X	17926624	0	90	1	26	117
X	17930651	0	99	0	45	144
X	17930658	0	120	0	22	142
X	17930733	0	64	0	86	150
X	17930890	0	78	0	17	95
X	17930948	0	40	0	41	81
X	17936502	0	5	0	38	43
X	17938011	0	0	0	220	220
X	17941537	0	0	0	21	21
X	17941569	0	1	0	22	23
X	17941570	0	1	0	22	23
X	17942236	0	0	0	27	27
X	17945833	0	5	0	24	29
X	17950057	0	50	0	285	335
X	17952716	0	15	0	279	294
X	17952717	0	15	0	280	295
X	17961411	0	3	0	0	3
X	17981650	0	18	0	35	53
X	17982144	0	43	0	12	55
X	17983811	0	26	0	38	64
X	17983847	0	45	0	12	57
X	17987714	0	2	0	45	47
X	17987788	0	15	0	53	68
X	17987790	0	31	0	34	65
X	17987796	0	18	0	43	61
X	17988376	0	0	0	20	20
X	17989432	0	6	0	52	58
X	17989433	0	42	0	17	59
X	17991679	0	0	0	1	1
X	17991684	0	0	0	1	1
X	17991689	0	0	0	1	1
X	17991690	0	0	0	1	1
X	17991691	0	0	0	1	1
X	18107572	0	0	0	17	17
X	18107970	0	4	0	15	19
X	18170126	31	0	44	0	75
X	18172085	131	0	0	0	131
X	18172108	114	0	0	0	114
X	18173979	75	0	8	0	83
X	18174020	62	0	15	0	77
X	18174056	65	0	11	0	76
X	18177807	12	0	1	0	13
X	18201429	63	0	14	0	77
X	18558815	4	0	0	0	4
X	18901523	6	0	1	0	7
X	19153046	0	0	0	64	64
X	19265115	13	0	16	0	29
X	19265410	1	0	5	0	6
X	19283881	0	21	0	51	72
X	19334465	0	89	0	13	102
X	19334522	0	26	0	62	88
X	19341081	0	1	0	60	61
X	19341084	0	6	0	55	61
X	19341882	0	3	0	114	117
X	19342007	0	76	1	65	142
X	19508447	268	0	44	0	312
X	19545747	0	0	0	1	1
X	19641588	0	42	0	64	106
X	19651650	0	0	0	12	12
X	19727697	8	0	112	0	120
X	19727698	11	0	107	0	118
X	19831888	0	1	0	17	18
X	19835017	0	4	0	21	25
X	19857622	12	0	0	0	12
X	19888186	1	0	1	0	2
X	20330037	0	1	0	0	1
X	20330041	0	1	0	0	1
X	20770084	0	21	0	23	44
X	20773442	0	22	0	14	36
X	20819626	0	0	0	0	0
X	20828303	0	0	0	8	8
X	20828316	0	1	0	7	8
X	20828348	0	4	0	3	7
X	20828364	0	5	0	0	5
X	20828369	0	3	0	1	4
X	20828370	0	2	0	2	4
X	20923843	0	7	0	19	26
X	20924823	0	2	0	4	6
X	21068672	0	0	0	0	0
X	21304740	0	1	0	0	1
X	21629428	0	138	0	183	321
X	21629453	0	126	0	203	329
X	21629508	0	58	0	267	325
X	21629725	0	177	0	134	311
X	21629726	0	123	0	183	306
X	21629727	0	135	0	179	314
X	21629737	0	166	0	151	317
X	22489005	4	0	8	0	12
X	22489022	13	0	0	0	13
X	22499716	60	0	14	0	74
X	22499717	40	0	30	0	70
X	22499732	27	0	49	0	76
X	22502642	253	0	35	0	288
X	22502713	72	0	207	0	279
X	22502735	217	0	67	0	284
X	22980987	0	11	0	206	217
X	22982709	0	432	0	213	645
X	22983936	0	27	0	6	33
X	22984239	0	15	0	30	45
X	22984267	0	9	0	40	49
X	22984352	0	0	0	31	31
X	23024266	0	0	1	0	1
X	23029207	4	0	1	0	5
X	23206974	0	0	0	0	0
Y	400261	0	0	0	0	0
Y	688072	0	0	0	0	0
Y_CP007107v1_random	40134	0	0	0	0	0
Y_DS485767v1_random	101	0	0	0	0	0
