#CHR	POS	Count_A	Count_C	Count_G	Count_T	Good_depth
2R	669894	0	0	0	0	0
2R	927745	0	10	0	24	34
2R	927747	0	6	0	30	36
2R	927763	0	5	0	28	33
2R	927764	0	14	0	20	34
2R	927773	0	17	0	16	33
2R	928819	0	44	0	31	75
2R	928861	0	7	0	63	70
2R	928866	0	29	0	38	67
2R	928867	1	7	0	60	68
2R	946817	0	8	0	14	22
2R	947223	0	1	0	2	3
2R	948265	0	2	0	4	6
2R	949521	0	8	0	2	10
2R	1268441	6	0	4	0	10
2R	1271549	0	0	0	0	0
2R	1362581	0	0	0	0	0
2R	1397455	0	0	0	0	0
2R	1424437	0	0	0	0	0
2R	1424453	0	0	0	0	0
2R	1591958	20	0	0	0	20
2R	1593302	24	0	0	0	24
2R	1593303	19	0	1	0	20
2R	1593310	22	0	3	0	25
2R	1593315	22	0	3	0	25
2R	1593825	11	0	1	0	12
2R	1594032	14	0	1	0	15
2R	1595342	9	0	1	0	10
2R	1595440	12	0	4	0	16
2R	1607075	0	0	0	0	0
2R	1728919	0	0	0	0	0
2R	1738108	0	0	0	0	0
2R	1865062	0	3	0	5	8
2R	1865075	0	5	0	3	8
2R	1865085	0	6	0	1	7
2R	1865087	0	4	0	3	7
2R	1865348	0	0	0	7	7
2R	1865369	0	3	0	4	7
2R	1865574	0	4	0	2	6
2R	1873696	0	0	0	1	1
2R	1891695	0	0	0	2	2
2R	1893555	0	0	0	0	0
2R	1895974	0	0	0	0	0
2R	1905603	0	0	0	0	0
2R	1916341	0	0	0	0	0
2R	1917254	0	0	0	1	1
2R	1958846	0	0	0	0	0
2R	1986061	0	0	0	2	2
2R	1994663	0	0	0	1	1
2R	1994676	0	0	0	1	1
2R	2080600	0	0	0	0	0
2R	2108301	0	0	0	3	3
2R	2191810	0	0	0	1	1
2R	2194077	0	0	0	0	0
2R	2195782	0	0	0	0	0
2R	2202217	0	0	0	1	1
2R	2202225	0	1	0	0	1
2R	2241894	0	0	0	0	0
2R	2246575	0	0	0	0	0
2R	2246585	0	0	0	0	0
2R	2246586	0	0	0	0	0
2R	2246597	0	0	0	0	0
2R	2246605	0	0	0	0	0
2R	2246607	0	0	0	0	0
2R	2246610	0	0	0	0	0
2R	2246614	0	0	0	0	0
2R	2246619	0	0	0	0	0
2R	2246626	0	0	0	0	0
2R	2246628	0	0	0	0	0
2R	2246630	0	0	0	0	0
2R	2246649	0	0	0	0	0
2R	2246650	0	0	0	0	0
2R	2246657	0	0	0	0	0
2R	2246661	0	0	0	0	0
2R	2246666	0	0	0	0	0
2R	2246668	0	0	0	0	0
2R	2246670	0	0	0	0	0
2R	2246672	0	0	0	0	0
2R	2246674	0	0	0	0	0
2R	2246677	0	0	0	0	0
2R	2246691	0	0	0	0	0
2R	2246694	0	0	0	0	0
2R	2246705	0	0	0	0	0
2R	2246718	0	0	0	0	0
2R	2246721	0	0	0	0	0
2R	2246725	0	0	0	0	0
2R	2246749	0	0	0	0	0
2R	2246751	0	0	0	0	0
2R	2246758	0	0	0	0	0
2R	2247749	0	0	0	0	0
2R	2256918	0	0	0	1	1
2R	2257284	0	0	0	1	1
2R	2257289	0	0	0	1	1
2R	2257295	0	0	0	1	1
2R	2257742	0	1	0	1	2
2R	2257793	0	1	0	1	2
2R	2257825	0	0	0	0	0
2R	2257846	0	1	0	1	2
2R	2260195	0	0	0	16	16
2R	2260208	0	0	0	18	18
2R	2260246	0	0	0	17	17
2R	2260647	0	3	0	4	7
2R	2487897	0	0	0	0	0
2R	2487913	0	0	0	0	0
2R	2495761	0	4	0	21	25
2R	2496768	0	19	0	19	38
2R	2496780	0	26	0	14	40
2R	2498338	0	1	0	6	7
2R	2498339	0	0	0	7	7
2R	2498347	0	4	0	3	7
2R	2498348	0	0	0	7	7
2R	2498350	0	2	0	5	7
2R	2498351	0	2	0	5	7
2R	2498353	0	1	0	5	6
2R	2498356	0	5	0	2	7
2R	2498359	0	1	0	6	7
2R	2498363	0	2	0	5	7
2R	2498364	0	3	0	4	7
2R	2517609	0	4	0	3	7
2R	2519999	0	3	0	12	15
2R	2554231	0	0	0	0	0
2R	2554519	0	0	0	0	0
2R	2554530	0	1	0	0	1
2R	2562370	0	0	0	5	5
2R	2562467	0	0	0	6	6
2R	2563510	0	0	0	3	3
2R	2640746	0	0	0	0	0
2R	2820914	0	1	0	0	1
2R	2821043	0	0	0	2	2
2R	2822225	0	0	0	3	3
2R	2822367	0	0	0	2	2
2R	2822866	0	0	0	1	1
2R	2822867	0	0	0	1	1
2R	2822874	0	0	0	1	1
2R	2822875	0	0	0	1	1
2R	2822877	0	0	0	1	1
2R	2822880	0	0	0	1	1
2R	2822883	0	0	0	1	1
2R	2822884	0	0	0	1	1
2R	2822887	0	0	0	1	1
2R	2822888	0	0	0	1	1
2R	2822893	0	0	0	1	1
2R	2822941	0	0	0	1	1
2R	2822942	0	0	0	1	1
2R	2822956	0	0	0	2	2
2R	2822957	0	0	0	2	2
2R	2822958	0	0	0	2	2
2R	2822961	0	0	0	2	2
2R	2822991	0	0	0	2	2
2R	2822995	0	0	0	2	2
2R	2822996	0	0	0	2	2
2R	2822997	0	0	0	2	2
2R	2823003	0	0	0	3	3
2R	2823005	0	0	0	3	3
2R	2823006	0	0	0	3	3
2R	2823007	0	0	0	3	3
2R	2823097	0	0	0	3	3
2R	2823428	0	0	0	0	0
2R	2823645	0	1	0	2	3
2R	2823852	0	0	0	0	0
2R	2831098	0	1	0	1	2
2R	2831110	0	1	0	1	2
2R	2832245	0	0	0	0	0
2R	2843105	0	1	0	4	5
2R	2843112	0	3	0	1	4
2R	2843113	0	1	0	3	4
2R	2843121	0	4	0	0	4
2R	2843122	0	0	0	4	4
2R	2843124	0	2	0	2	4
2R	2843130	0	4	0	0	4
2R	2846308	0	0	0	2	2
2R	2954347	0	0	0	0	0
2R	2954369	0	0	0	0	0
2R	2954754	0	0	0	0	0
2R	2970910	0	0	0	0	0
2R	3104182	0	0	0	0	0
2R	3190285	3	0	5	0	8
2R	3919432	0	3	0	1	4
2R	3932880	0	1	0	0	1
2R	3941840	0	3	0	1	4
2R	4052078	2	0	0	0	2
2R	4052143	2	0	0	0	2
2R	4052192	1	0	0	0	1
2R	4052205	1	0	0	0	1
2R	4052208	0	0	0	0	0
2R	4052224	0	0	0	0	0
2R	4052238	0	0	0	0	0
2R	4052252	0	0	0	0	0
2R	4052268	0	0	0	0	0
2R	4052279	0	0	0	0	0
2R	4220796	0	0	0	0	0
2R	4350268	0	0	0	0	0
2R	4350386	0	0	0	0	0
2R	4367099	0	0	0	0	0
2R	4397570	0	0	0	0	0
2R	4397571	0	0	0	0	0
2R	4397577	0	0	0	0	0
2R	4397580	0	0	0	0	0
2R	4397583	0	0	0	0	0
2R	4397588	0	0	0	0	0
2R	4397601	0	0	0	0	0
2R	4397632	0	0	0	0	0
2R	4397638	0	0	0	0	0
2R	4397643	0	0	0	0	0
2R	4397645	0	0	0	0	0
2R	4397646	0	0	0	0	0
2R	4397658	0	0	0	0	0
2R	4407456	0	0	0	0	0
2R	4407479	0	0	0	0	0
2R	4470411	0	0	0	2	2
2R	4598137	2	0	3	0	5
2R	4610290	3	0	0	0	3
2R	4610327	2	0	1	0	3
2R	4610328	2	0	1	0	3
2R	4610335	2	0	1	0	3
2R	4610338	3	0	0	0	3
2R	4610340	3	0	0	0	3
2R	4610343	3	0	0	0	3
2R	4610344	2	0	1	0	3
2R	4749085	10	0	1	0	11
2R	4787711	1	11	0	91	103
2R	4790435	0	0	0	0	0
2R	4795353	0	0	0	0	0
2R	5027097	0	0	0	0	0
2R	5068277	0	1	0	3	4
2R	5069358	0	0	0	0	0
2R	5069359	0	0	0	0	0
2R	5069360	0	0	0	0	0
2R	5119406	0	6	0	12	18
2R	5120152	0	1	0	7	8
2R	5124254	0	2	0	0	2
2R	5127276	0	2	0	3	5
2R	5211451	0	0	0	0	0
2R	5302757	0	0	0	0	0
2R	5320850	9	0	2	0	11
2R	5337012	0	0	0	0	0
2R	5495400	0	0	0	6	6
2R	5503750	0	0	0	0	0
2R	5503767	0	0	0	0	0
2R	5503911	0	0	0	0	0
2R	5503915	0	0	0	0	0
2R	5504022	0	0	0	0	0
2R	5504026	0	0	0	0	0
2R	5504425	0	0	0	0	0
2R	5504526	0	0	0	0	0
2R	5505677	0	0	0	0	0
2R	5505735	0	0	0	0	0
2R	5505798	0	0	0	0	0
2R	5505800	0	0	0	0	0
2R	5505852	0	0	0	0	0
2R	6031677	0	0	0	0	0
2R	6039689	0	10	0	13	23
2R	6174962	289	0	0	0	289
2R	6571523	0	0	0	0	0
2R	6725344	0	1	0	34	35
2R	6733080	0	1	0	39	40
2R	6733220	0	1	0	37	38
2R	6817728	6	0	9	0	15
2R	6927455	0	6	0	21	27
2R	7130316	0	0	0	19	19
2R	7401894	0	0	0	0	0
2R	7501178	18	0	54	0	72
2R	7502188	11	0	32	0	43
2R	7502199	17	0	19	0	36
2R	7664923	21	0	0	0	21
2R	7813863	83	0	53	0	136
2R	8100701	54	0	29	0	83
2R	8144501	0	2	0	0	2
2R	8464487	173	0	0	1	174
2R	8482655	0	0	0	37	37
2R	8511471	0	0	0	0	0
2R	8616059	137	0	0	0	137
2R	8618670	252	0	0	0	252
2R	8696454	29	0	2	0	31
2R	8876533	63	0	8	0	71
2R	8876790	57	0	11	0	68
2R	8877577	62	0	8	0	70
2R	8883706	2	0	96	0	98
2R	8883745	64	0	41	0	105
2R	8885231	83	0	24	0	107
2R	8885377	72	0	36	0	108
2R	8903673	1402	0	71	0	1473
2R	8903674	1267	0	121	0	1388
2R	8903680	1181	0	340	0	1521
2R	8912445	0	0	0	5	5
2R	9100226	16	0	0	0	16
2R	9110821	3	0	0	0	3
2R	9119427	19	0	0	0	19
2R	9120392	50	0	24	0	74
2R	9158865	0	0	0	39	39
2R	9168104	0	0	0	42	42
2R	9171291	0	0	0	40	40
2R	9171360	0	0	0	40	40
2R	9191664	0	0	0	151	151
2R	9229669	0	27	0	203	230
2R	9229804	0	108	0	414	522
2R	9229936	0	196	0	329	525
2R	9232371	0	0	0	20	20
2R	9234514	0	250	0	197	447
2R	9234519	0	282	0	158	440
2R	9311068	0	6	0	74	80
2R	9312080	0	18	0	42	60
2R	9312087	0	18	0	48	66
2R	9312091	0	5	0	60	65
2R	9312092	33	7	0	24	64
2R	9312093	0	5	0	55	60
2R	9312094	0	2	0	60	62
2R	9328201	0	2	0	5	7
2R	9344191	0	0	0	1	1
2R	9344213	0	1	0	0	1
2R	9345714	0	1	0	2	3
2R	9369253	0	0	0	2	2
2R	9408179	0	2	0	3	5
2R	9440747	0	53	0	10	63
2R	9534930	166	0	54	0	220
2R	9534943	227	0	13	0	240
2R	9539059	0	59	0	121	180
2R	9542736	0	3	0	1	4
2R	9542851	0	0	0	2	2
2R	9592745	1	0	0	0	1
2R	9598728	9	0	0	0	9
2R	9599645	3	0	0	0	3
2R	9619360	0	0	0	0	0
2R	9633098	0	0	0	0	0
2R	9721527	0	0	0	4	4
2R	9723564	0	1	0	34	35
2R	9739197	0	0	0	0	0
2R	9753896	1045	0	63	0	1108
2R	9817692	0	0	0	18	18
2R	9819309	0	1	0	22	23
2R	9819328	0	1	0	22	23
2R	9819477	0	2	0	27	29
2R	9819490	0	6	0	21	27
2R	9884160	0	19	0	152	171
2R	9927725	0	1	0	0	1
2R	10011276	0	0	0	0	0
2R	10091619	21	0	0	0	21
2R	10108800	810	0	398	0	1208
2R	10108801	872	0	341	0	1213
2R	10108802	972	0	226	0	1198
2R	10222721	0	0	0	0	0
2R	10278408	10	0	0	0	10
2R	10279089	30	0	0	0	30
2R	10280883	39	0	24	0	63
2R	10280988	43	0	43	0	86
2R	10285619	102	0	0	1	103
2R	10321544	13	0	0	0	13
2R	10327175	0	8	0	6	14
2R	10330783	0	0	0	8	8
2R	10330787	0	5	0	2	7
2R	10330795	0	2	0	4	6
2R	10330796	0	0	0	7	7
2R	10330801	0	3	0	4	7
2R	10330802	0	3	0	3	6
2R	10336774	0	42	0	26	68
2R	10378403	0	0	0	0	0
2R	10378432	0	0	0	0	0
2R	10378433	0	0	0	0	0
2R	10392192	0	0	0	8	8
2R	10393990	0	0	0	5	5
2R	10472135	1	150	0	105	256
2R	10531606	0	0	0	12	12
2R	10540485	0	1	0	0	1
2R	10611461	141	0	12	0	153
2R	10611464	129	0	26	0	155
2R	10706747	8	0	4	0	12
2R	10783584	0	0	0	0	0
2R	10785766	0	0	0	0	0
2R	10785846	0	2	0	1	3
2R	10788717	2	0	0	0	2
2R	10789955	0	0	2	0	2
2R	10815342	54	0	0	0	54
2R	10837913	0	453	0	0	453
2R	10840470	0	93	0	13	106
2R	10855471	0	0	0	0	0
2R	11148789	0	15	0	28	43
2R	11229833	0	0	0	120	120
2R	11293045	0	14	0	46	60
2R	11447601	73	0	325	0	398
2R	11447607	15	0	398	0	413
2R	11447617	67	0	344	0	411
2R	11447623	110	0	323	1	434
2R	11447933	433	0	0	0	433
2R	11447935	403	0	35	1	439
2R	11447987	262	0	190	0	452
2R	11450317	203	0	225	0	428
2R	11450318	222	0	214	0	436
2R	11603464	0	0	0	0	0
2R	11635584	0	0	0	1	1
2R	11635585	0	0	0	0	0
2R	11635587	0	0	0	0	0
2R	11635588	0	1	0	0	1
2R	11671280	0	0	0	4	4
2R	11779856	0	0	0	0	0
2R	11827392	0	0	0	11	11
2R	11845525	45	0	5	0	50
2R	11893047	9	0	0	0	9
2R	11990709	22	0	5	0	27
2R	12024356	0	2	0	3	5
2R	12025551	0	2	0	2	4
2R	12025588	0	5	0	0	5
2R	12265428	7	0	0	0	7
2R	12269039	4	0	2	0	6
2R	12328060	42	0	0	0	42
2R	12328068	46	0	0	0	46
2R	12328073	49	0	0	0	49
2R	12329738	0	0	0	0	0
2R	12350262	4	0	0	0	4
2R	12448654	106	0	31	0	137
2R	12448686	83	0	75	0	158
2R	12448723	123	0	50	0	173
2R	12448779	85	0	104	0	189
2R	12469039	7	0	0	0	7
2R	12470834	6	0	0	0	6
2R	12489327	0	0	0	118	118
2R	12648195	0	0	0	3	3
2R	12754897	0	5	0	0	5
2R	12758582	66	0	87	0	153
2R	12800608	4	0	24	0	28
2R	12800859	37	0	5	0	42
2R	12921246	224	0	144	0	368
2R	12921325	268	0	148	0	416
2R	12921326	339	0	82	0	421
2R	13437401	0	0	0	15	15
2R	13517261	0	10	0	196	206
2R	13517274	0	57	0	129	186
2R	13517275	0	128	0	53	181
2R	13517347	0	30	0	117	147
2R	13580366	2	0	0	0	2
2R	13747628	1	0	36	0	37
2R	13748897	0	0	52	0	52
2R	13809071	46	0	8	0	54
2R	13809547	22	0	133	0	155
2R	13809607	84	0	60	0	144
2R	13809962	115	0	76	0	191
2R	13810199	91	0	57	0	148
2R	13817109	137	0	54	0	191
2R	13817124	169	2	10	0	181
2R	13817379	52	0	244	0	296
2R	13823895	0	0	0	73	73
2R	13846257	2	0	0	0	2
2R	13858942	0	0	0	0	0
2R	13885952	0	0	0	114	114
2R	13886458	1	18	0	49	68
2R	13887556	0	53	0	30	83
2R	13893580	0	6	0	53	59
2R	13893934	0	39	0	19	58
2R	13916837	0	0	0	0	0
2R	13974052	0	0	0	64	64
2R	14062507	0	16	0	70	86
2R	14062651	0	46	0	47	93
2R	14062768	0	40	0	74	114
2R	14062771	0	63	0	52	115
2R	14062774	0	17	0	99	116
2R	14149035	0	0	0	63	63
2R	14152423	0	11	0	0	11
2R	14153104	0	2	0	0	2
2R	14171351	26	0	1	0	27
2R	14172781	254	0	54	0	308
2R	14178731	147	0	33	0	180
2R	14182106	84	0	11	0	95
2R	14215739	0	2	0	1	3
2R	14297994	302	0	53	0	355
2R	14331618	0	0	0	0	0
2R	14334547	0	0	0	0	0
2R	14355520	23	0	6	0	29
2R	14361978	0	5	0	0	5
2R	14507629	56	0	0	0	56
2R	14538499	0	0	0	0	0
2R	14555183	0	0	1	0	1
2R	14740426	0	11	0	306	317
2R	14741592	0	165	0	121	286
2R	14742174	0	36	1	326	363
2R	14742210	0	129	0	228	357
2R	14742223	0	86	1	267	354
2R	14742241	0	306	0	49	355
2R	14742359	0	1	0	372	373
2R	14756598	346	0	0	0	346
2R	14762018	0	97	0	151	248
2R	14971913	0	0	109	0	109
2R	15264046	0	45	0	43	88
2R	15264051	0	31	0	56	87
2R	15264096	0	62	0	28	90
2R	15264743	0	17	0	50	67
2R	15415679	18	0	0	0	18
2R	15456269	3	0	0	0	3
2R	15460575	13	0	0	0	13
2R	15460578	13	0	0	0	13
2R	15516140	0	4	0	49	53
2R	15518712	0	50	0	78	128
2R	15765728	0	0	0	30	30
2R	15766457	0	0	0	16	16
2R	15772754	0	0	0	6	6
2R	15772755	0	0	0	6	6
2R	15775053	1	2	0	32	35
2R	15777061	0	5	0	1	6
2R	15779915	0	0	0	2	2
2R	15779918	0	0	0	2	2
2R	15779987	0	2	0	0	2
2R	15779998	0	0	0	1	1
2R	15786556	0	0	0	0	0
2R	15809225	0	0	0	4	4
2R	15871835	0	67	0	29	96
2R	15872366	0	77	1	43	121
2R	15980167	0	0	0	2	2
2R	16336488	5	0	1	0	6
2R	16432544	19	0	0	0	19
2R	16534056	0	0	0	0	0
2R	16576409	0	84	1	0	85
2R	16647491	62	0	8	0	70
2R	16647492	15	0	55	0	70
2R	16647565	69	0	14	0	83
2R	16647597	73	0	14	0	87
2R	16647631	15	0	74	0	89
2R	16650664	61	0	0	0	61
2R	16650669	53	0	0	0	53
2R	16650728	66	0	0	0	66
2R	16650742	69	0	0	0	69
2R	16650776	54	0	16	0	70
2R	16650779	61	0	9	0	70
2R	16650790	40	0	29	0	69
2R	16650805	52	0	16	0	68
2R	16650890	56	0	10	0	66
2R	16762451	0	0	0	2	2
2R	16765101	0	1	0	12	13
2R	16917584	0	0	0	0	0
2R	16932924	23	0	0	0	23
2R	17222715	0	0	0	0	0
2R	17364649	7	0	3	0	10
2R	17374869	18	0	22	0	40
2R	17375028	44	0	13	0	57
2R	17375029	52	0	5	0	57
2R	17375057	26	0	32	0	58
2R	17375058	37	0	23	0	60
2R	17377109	20	0	62	0	82
2R	17377110	23	0	59	0	82
2R	17377122	33	0	49	0	82
2R	17377125	47	0	33	0	80
2R	17377403	47	0	22	0	69
2R	17701194	0	0	1	0	1
2R	18020907	0	0	0	0	0
2R	18134284	0	0	0	9	9
2R	18145289	9	0	0	0	9
2R	18167781	131	0	0	0	131
2R	18173890	36	0	9	0	45
2R	18281192	0	0	0	91	91
2R	18356868	0	2	0	12	14
2R	18518047	6	0	0	0	6
2R	18518048	4	0	2	0	6
2R	18720854	1	0	0	0	1
2R	18743376	0	0	0	3	3
2R	18865057	0	0	0	1	1
2R	18998450	10	0	0	0	10
2R	19006082	77	0	30	0	107
2R	19006586	0	0	0	0	0
2R	19138221	0	0	0	3	3
2R	19139754	124	0	0	0	124
2R	19179174	8	0	2	0	10
2R	19223379	49	0	15	0	64
2R	19223636	55	0	53	0	108
2R	19225658	111	0	48	0	159
2R	19303685	50	0	11	0	61
2R	19326309	0	23	0	22	45
2R	19525936	0	0	0	26	26
2R	19566903	0	3	0	21	24
2R	19625834	0	0	0	0	0
2R	19727230	0	0	0	0	0
2R	20424540	92	0	0	0	92
2R	20658504	0	0	7	0	7
2R	21145178	461	0	38	0	499
2R	21315686	138	0	52	0	190
2R	21334960	8	0	12	0	20
2R	21480214	0	12	2	45	59
2R	21557174	33	0	38	0	71
2R	21620849	0	35	0	37	72
2R	21621075	0	28	0	26	54
2R	21653466	30	0	41	0	71
2R	21851363	0	0	0	0	0
2R	22175545	25	0	0	0	25
2R	22227209	0	0	0	34	34
2R	22391510	22	0	70	0	92
2R	22564373	0	32	0	79	111
2R	22564377	0	31	0	78	109
2R	22568445	0	0	0	0	0
2R	22573070	0	0	0	0	0
2R	22587796	0	0	0	0	0
2R	22637905	69	0	0	0	69
2R	22673075	18	1	0	0	19
2R	22746263	0	1	0	6	7
2R	23381950	0	0	0	27	27
2R	23598132	8	0	1	0	9
2R	23804970	0	0	0	0	0
2R	23838782	37	0	3	0	40
2R	23844274	0	0	0	61	61
2R	23867196	1	0	0	323	324
2R	24006102	0	3	0	67	70
2R	24006115	0	0	0	73	73
2R	24006555	0	62	0	9	71
2R	24046125	0	1	0	2	3
2R	24050977	40	0	27	0	67
2R	24051555	56	0	12	0	68
2R	24218949	0	0	0	0	0
2R	24332337	0	0	0	2	2
2R	24384812	0	74	0	13	87
2R	24419247	0	122	0	13	135
2R	24419250	0	115	0	17	132
2R	24500965	0	0	0	0	0
2R	24512318	0	22	0	90	112
2R	24882682	132	0	12	0	144
2R	24882751	125	0	36	0	161
2R	24885850	91	0	22	0	113
2R	24904717	161	0	13	0	174
2R	24910398	154	0	95	0	249
2R	24910568	163	0	84	0	247
2R	24910752	143	0	47	0	190
2R	24910775	43	0	132	0	175
2R	24910814	112	0	91	0	203
2R	24910823	93	0	115	0	208
2R	24911061	74	0	115	0	189
2R	24911109	81	0	116	0	197
2R	24912004	109	0	24	0	133
2R	24912848	32	0	174	0	206
2R	24912923	226	0	0	0	226
2R	24914689	166	0	42	0	208
2R	24914702	63	0	137	1	201
2R	24914794	52	0	114	0	166
2R	24914829	142	0	32	0	174
2R	24914858	16	0	176	0	192
2R	24914859	184	0	8	0	192
2R	24914864	52	0	146	0	198
2R	24914865	75	0	126	0	201
2R	24914874	89	0	109	0	198
2R	24919093	212	0	29	0	241
2R	24920153	103	0	5	0	108
2R	24995597	0	34	0	71	105
2R	24995857	0	46	0	51	97
2R	25255069	38	0	2	0	40
2R	25255079	22	0	19	0	41
2R	25255082	19	0	23	0	42
2R	25255913	79	0	8	0	87
2R	25256658	23	0	16	0	39
2R	25257110	34	0	4	0	38
2R	25257267	29	0	36	0	65
2R	25257297	54	0	19	0	73
2R	25257312	26	0	44	0	70
2R	25257313	10	0	61	0	71
2R	25257314	28	0	42	0	70
2R	25257317	40	0	29	0	69
2R	25257328	49	0	22	0	71
2R	25257336	60	0	5	0	65
2R	25257337	53	0	13	0	66
2R	25257342	16	0	55	0	71
2R	25257343	16	0	55	0	71
2R	25257375	71	0	0	0	71
2R	25257376	62	0	11	0	73
2R	25257377	41	0	34	0	75
2R	25257383	38	0	35	0	73
2R	25257388	52	0	26	0	78
2R	25257391	57	0	25	0	82
2R	25257392	70	0	13	0	83
2R	25257393	76	0	7	0	83
2R	25257394	55	0	29	0	84
2R	25257396	86	0	0	0	86
2R	25257397	71	0	17	0	88
2R	25257398	66	0	21	0	87
2R	25257404	43	0	38	0	81
2R	25257405	30	0	53	0	83
2R	25257406	34	0	51	0	85
2R	25257414	75	0	11	0	86
2R	25257417	46	0	44	0	90
2R	25257418	41	0	48	0	89
2R	25257420	77	0	13	0	90
2R	25257424	87	0	8	0	95
2R	25257425	39	0	56	0	95
2R	25257426	23	0	73	0	96
2R	25257427	83	0	15	0	98
2R	25257431	84	0	16	0	100
2R	25257439	81	0	19	0	100
2R	25257445	73	0	21	0	94
2R	25257451	39	0	51	0	90
2R	25257453	85	0	4	0	89
2R	25257483	71	1	18	0	90
2R	25257508	53	0	51	0	104
2R	25257625	61	0	10	0	71
2R	25257632	63	0	8	0	71
2R	25257633	67	0	1	0	68
2R	25257638	74	0	0	0	74
2R	25257643	46	0	23	0	69
2R	25257682	17	0	32	0	49
2R	25257683	25	0	24	0	49
2R	25257699	38	0	2	0	40
2R	25257701	28	0	14	0	42
2R	25257703	17	0	23	0	40
2R	25257714	27	0	17	0	44
2R	25257732	17	0	21	0	38
2R	25257735	20	0	19	0	39
2R	25257740	16	0	19	0	35
2R	25257741	27	0	10	0	37
2R	25257743	32	0	5	0	37
2R	25257781	29	0	9	0	38
2R	25257788	38	0	1	0	39
2R	25257789	32	0	2	0	34
2R	25257792	27	0	6	0	33
2R	25257806	8	0	17	0	25
2R	25257812	20	0	3	0	23
2R	25257820	19	0	5	0	24
2R	25257832	11	0	16	0	27
2R	25257836	5	0	20	0	25
2R	25257964	3	0	13	0	16
3L	71000	0	0	0	0	0
3L	214328	0	34	0	0	34
3L	226141	2232	0	96	0	2328
3L	271201	0	0	2	0	2
3L	336697	1	0	0	0	1
3L	346424	1	0	0	0	1
3L	346882	0	0	0	16	16
3L	411895	0	0	0	0	0
3L	462074	0	0	0	0	0
3L	498116	0	0	0	0	0
3L	546751	2	0	0	0	2
3L	575217	45	0	0	0	45
3L	598790	20	0	13	0	33
3L	991441	100	0	17	0	117
3L	1010857	0	0	0	0	0
3L	1011246	0	0	0	0	0
3L	1011285	0	0	0	0	0
3L	1026639	0	7	0	78	85
3L	1027109	0	40	0	86	126
3L	1033059	0	0	0	0	0
3L	1034384	0	0	0	0	0
3L	1034386	0	0	0	0	0
3L	1044064	0	0	0	0	0
3L	1046651	0	0	0	1	1
3L	1135014	0	0	0	0	0
3L	1138357	0	0	0	0	0
3L	1210848	1	0	0	0	1
3L	1217228	0	0	0	0	0
3L	1227904	2	0	0	0	2
3L	1230644	0	0	55	0	55
3L	1318745	0	2	0	0	2
3L	1407143	0	0	0	0	0
3L	1490348	0	1	0	6	7
3L	1526045	0	0	0	16	16
3L	1556299	0	0	0	200	200
3L	1689558	11	0	0	0	11
3L	1727806	0	0	0	0	0
3L	1782670	2	248	3	205	458
3L	1945203	0	0	0	8	8
3L	2001719	0	0	0	0	0
3L	2039782	0	2	0	53	55
3L	2039908	0	14	0	76	90
3L	2039918	0	38	0	56	94
3L	2039919	0	5	0	91	96
3L	2042849	0	0	0	116	116
3L	2043519	0	0	0	138	138
3L	2044551	0	0	0	100	100
3L	2044916	0	0	0	111	111
3L	2045959	0	0	0	96	96
3L	2051548	0	0	0	47	47
3L	2054348	0	0	0	1	1
3L	2055902	0	0	0	3	3
3L	2056964	0	0	0	1	1
3L	2060460	0	0	0	5	5
3L	2074107	0	0	0	16	16
3L	2080672	0	0	0	21	21
3L	2080891	0	0	0	21	21
3L	2089039	0	0	0	21	21
3L	2096769	0	0	0	63	63
3L	2125496	0	0	0	173	173
3L	2126093	0	21	0	209	230
3L	2134649	0	2	0	74	76
3L	2135049	0	0	0	115	115
3L	2190111	0	0	0	127	127
3L	2245947	1	0	0	0	1
3L	2251644	0	0	0	0	0
3L	2348350	0	0	0	0	0
3L	2372937	0	0	31	0	31
3L	2377732	0	0	0	2	2
3L	2390472	0	0	1	0	1
3L	2424958	0	0	0	0	0
3L	2440451	7	0	0	0	7
3L	2458238	20	0	0	0	20
3L	2469405	1	0	0	0	1
3L	2469912	0	0	0	0	0
3L	2473344	0	0	0	0	0
3L	2481805	0	0	0	0	0
3L	2498728	0	0	0	87	87
3L	2499964	0	0	0	1434	1434
3L	2519293	0	0	0	1	1
3L	2578670	0	0	0	0	0
3L	2657532	0	100	0	0	100
3L	2665990	0	12	0	60	72
3L	2666151	0	46	0	15	61
3L	2773256	0	0	0	72	72
3L	2773526	0	0	0	56	56
3L	2777176	0	0	61	0	61
3L	2778433	39	0	0	0	39
3L	2778439	0	0	40	0	40
3L	2784069	0	14	0	0	14
3L	2784359	0	0	18	0	18
3L	2785524	0	0	30	0	30
3L	2785531	0	0	0	28	28
3L	2785536	0	0	0	27	27
3L	2785542	0	27	0	0	27
3L	2785610	0	22	0	0	22
3L	2785621	0	0	0	23	23
3L	2785658	22	0	0	0	22
3L	2786034	0	0	0	0	0
3L	2791593	0	0	0	53	53
3L	2799685	0	1	0	0	1
3L	2882059	0	0	0	0	0
3L	2924789	177	0	14	0	191
3L	2924790	178	0	15	0	193
3L	2924829	112	0	58	0	170
3L	2925090	42	0	91	0	133
3L	2925255	18	1	138	0	157
3L	2925550	0	0	58	0	58
3L	2939953	67	0	46	0	113
3L	2940825	181	0	8	0	189
3L	2940919	147	0	31	0	178
3L	2941131	40	0	165	0	205
3L	2941132	11	0	196	0	207
3L	2941311	167	0	15	0	182
3L	2941312	11	0	173	0	184
3L	2941364	13	0	186	0	199
3L	2941396	29	1	151	0	181
3L	2941425	64	0	127	0	191
3L	2941426	5	0	183	0	188
3L	2961305	0	0	0	0	0
3L	3086223	145	0	41	0	186
3L	3114961	0	0	0	82	82
3L	3150180	0	0	1	0	1
3L	3226015	13	0	6	0	19
3L	3311439	0	0	0	0	0
3L	3359345	38	0	51	0	89
3L	3361215	0	123	0	0	123
3L	3371858	0	110	0	41	151
3L	3371901	0	83	0	68	151
3L	3371976	0	47	0	158	205
3L	3407053	0	0	0	1	1
3L	3442381	0	0	0	1	1
3L	3471786	0	0	0	69	69
3L	3555912	0	0	0	0	0
3L	3729820	0	0	0	0	0
3L	3761976	0	0	0	0	0
3L	3762337	0	0	0	1	1
3L	3781259	0	24	0	0	24
3L	3786975	0	0	0	0	0
3L	3815844	0	0	0	0	0
3L	3837134	102	0	0	0	102
3L	3892642	0	0	82	0	82
3L	3904309	0	0	0	0	0
3L	3988087	53	0	4	0	57
3L	4089220	0	0	0	0	0
3L	4092326	907	0	13	1	921
3L	4172458	0	0	54	0	54
3L	4198341	26	0	22	0	48
3L	4264563	0	0	0	0	0
3L	4307932	0	0	0	0	0
3L	4308806	0	0	0	0	0
3L	4314575	0	0	0	0	0
3L	4314576	0	0	0	0	0
3L	4314586	0	0	0	0	0
3L	4316475	0	0	0	0	0
3L	4317484	0	5	0	0	5
3L	4317522	0	0	0	0	0
3L	4317524	0	0	0	0	0
3L	4317564	0	0	4	0	4
3L	4318105	0	0	1	0	1
3L	4318481	0	0	0	0	0
3L	4369162	0	167	0	94	261
3L	4369184	0	191	0	71	262
3L	4369185	0	105	0	156	261
3L	4369207	0	13	0	302	315
3L	4369208	0	9	0	305	314
3L	4369213	0	26	0	285	311
3L	4369313	0	0	0	308	308
3L	4369422	0	61	0	166	227
3L	4369445	0	15	0	194	209
3L	4369455	0	12	0	228	240
3L	4369459	0	16	0	221	237
3L	4429963	16	0	253	0	269
3L	4429967	154	0	116	0	270
3L	4430199	98	0	30	2	130
3L	4430208	26	0	119	0	145
3L	4431761	19	0	176	0	195
3L	4432486	91	0	118	0	209
3L	4432487	52	0	150	0	202
3L	4433319	196	0	116	0	312
3L	4433320	32	0	283	0	315
3L	4446288	0	0	0	0	0
3L	4584256	20	0	90	0	110
3L	4585849	70	0	35	0	105
3L	4585851	90	0	15	0	105
3L	4585858	80	0	25	0	105
3L	4585859	15	0	86	0	101
3L	4585865	71	0	30	0	101
3L	4586039	75	0	2	0	77
3L	4586053	59	0	20	0	79
3L	4586714	344	0	85	0	429
3L	4586715	85	0	329	0	414
3L	4590437	192	0	34	0	226
3L	4590448	186	0	48	0	234
3L	4590461	229	0	11	1	241
3L	4590463	229	0	9	0	238
3L	4590484	235	0	24	1	260
3L	4590685	141	0	119	0	260
3L	4590708	182	0	93	0	275
3L	4590709	104	0	175	0	279
3L	4591116	105	0	105	0	210
3L	4591123	182	0	30	0	212
3L	4591132	187	0	29	0	216
3L	4591179	222	0	39	0	261
3L	4591222	256	0	38	0	294
3L	4591226	298	0	17	0	315
3L	4591259	264	0	24	0	288
3L	4591369	249	0	32	0	281
3L	4591744	255	0	11	0	266
3L	4732441	0	0	0	0	0
3L	4811851	0	0	2	0	2
3L	4822418	56	0	0	0	56
3L	4822420	53	0	0	0	53
3L	4867777	0	0	0	0	0
3L	4897294	0	1	0	0	1
3L	4985909	0	1	0	0	1
3L	4986257	0	0	0	0	0
3L	4986611	0	0	0	0	0
3L	4986891	0	0	0	0	0
3L	5045427	0	0	0	0	0
3L	5102529	0	0	0	0	0
3L	5116849	0	1	0	0	1
3L	5133159	0	0	10	0	10
3L	5133686	0	0	0	0	0
3L	5135062	91	0	0	0	91
3L	5135116	104	0	0	0	104
3L	5139737	47	0	0	0	47
3L	5144164	0	0	9	0	9
3L	5157874	0	7	0	131	138
3L	5160640	0	3	0	79	82
3L	5171594	0	0	0	0	0
3L	5171618	0	0	0	0	0
3L	5185014	0	0	0	0	0
3L	5188016	0	0	0	2	2
3L	5191766	0	0	0	0	0
3L	5192055	1	0	0	0	1
3L	5212866	2	0	0	0	2
3L	5212915	0	3	0	0	3
3L	5212920	0	2	0	0	2
3L	5213133	0	0	0	0	0
3L	5213134	0	0	0	0	0
3L	5247676	0	0	0	13	13
3L	5334897	0	0	0	0	0
3L	5347418	0	0	0	0	0
3L	5435357	0	0	0	0	0
3L	5664597	1	0	0	0	1
3L	5692734	0	0	1	0	1
3L	5696130	10	0	12	0	22
3L	5740525	15	0	25	0	40
3L	5743791	27	0	6	0	33
3L	5745060	27	0	8	0	35
3L	5746701	172	0	0	0	172
3L	5746708	172	0	11	0	183
3L	5746772	160	0	39	0	199
3L	5750034	0	0	0	3	3
3L	5764525	0	0	0	127	127
3L	5815976	0	0	2	0	2
3L	6008890	0	0	0	0	0
3L	6008957	0	0	0	0	0
3L	6009017	0	0	0	0	0
3L	6062381	0	0	0	0	0
3L	6193542	25	0	0	0	25
3L	6285897	0	0	0	0	0
3L	6331348	15	0	0	0	15
3L	6459287	0	0	0	0	0
3L	6506202	0	0	0	0	0
3L	6506212	0	0	0	0	0
3L	6534871	0	0	0	0	0
3L	6641116	0	0	0	0	0
3L	6643565	0	0	0	0	0
3L	6643648	0	0	0	0	0
3L	6643649	0	0	0	0	0
3L	6643749	0	0	0	0	0
3L	6643752	0	0	0	0	0
3L	6689091	0	0	0	0	0
3L	6689204	0	0	0	0	0
3L	6694843	0	0	0	0	0
3L	6734513	45	0	0	0	45
3L	6754914	0	36	0	0	36
3L	6769182	0	0	0	0	0
3L	6786307	0	0	5	0	5
3L	6800394	0	0	0	0	0
3L	6800402	0	0	0	2	2
3L	6949680	1	107	0	488	596
3L	6949683	0	33	0	585	618
3L	6949688	0	133	0	496	629
3L	6949690	1	161	1	466	629
3L	6950110	0	249	0	519	768
3L	6950168	0	144	0	843	987
3L	6954754	0	586	0	752	1338
3L	7021467	0	0	0	0	0
3L	7059577	0	0	0	35	35
3L	7180438	0	35	0	35	70
3L	7218079	0	0	0	0	0
3L	7235679	0	0	0	0	0
3L	7236912	0	0	0	0	0
3L	7324105	0	0	0	27	27
3L	7326096	27	0	0	0	27
3L	7417841	0	0	0	0	0
3L	7650269	0	0	0	0	0
3L	7654672	0	9	0	60	69
3L	7665256	577	0	0	1	578
3L	7666636	0	24	1	27	52
3L	7694236	0	0	0	0	0
3L	7696248	0	0	0	6	6
3L	7830703	0	5	0	18	23
3L	7923214	0	0	0	0	0
3L	7928680	0	69	0	30	99
3L	7939905	0	0	0	0	0
3L	7960324	0	0	0	0	0
3L	7979842	0	0	0	0	0
3L	8041599	0	0	0	0	0
3L	8066395	0	0	0	0	0
3L	8120375	0	0	82	0	82
3L	8120519	0	0	119	0	119
3L	8121502	3	0	0	0	3
3L	8126738	0	0	36	0	36
3L	8126864	19	0	0	0	19
3L	8184846	0	0	45	0	45
3L	8185142	0	0	2	0	2
3L	8228580	0	0	0	0	0
3L	8375374	0	0	0	0	0
3L	8434395	0	0	0	97	97
3L	8444869	0	2	0	0	2
3L	8492631	0	0	0	0	0
3L	8532834	0	0	0	71	71
3L	8532845	0	68	0	0	68
3L	8588267	0	0	198	0	198
3L	8588835	5	0	0	0	5
3L	8589446	24	0	2	0	26
3L	8597507	289	0	0	0	289
3L	8648332	11713	2	1	0	11716
3L	8678627	0	0	86	0	86
3L	8678628	0	0	89	0	89
3L	8678673	111	0	0	0	111
3L	8719077	10	0	0	0	10
3L	8724069	3	0	0	0	3
3L	8736015	0	0	0	4	4
3L	8740095	0	10	0	288	298
3L	8759599	13	0	0	0	13
3L	8775212	0	0	0	0	0
3L	8786152	68	0	0	0	68
3L	8798415	54	0	0	0	54
3L	8827752	0	0	65	0	65
3L	8839904	0	0	0	0	0
3L	8844956	0	0	0	0	0
3L	8850667	1	0	0	0	1
3L	8885355	1	0	0	0	1
3L	8892723	1	0	0	0	1
3L	8913159	0	0	0	0	0
3L	8913856	0	0	0	0	0
3L	8913897	0	0	0	0	0
3L	8931961	21	0	0	0	21
3L	8940166	49	0	0	0	49
3L	8983591	0	367	0	0	367
3L	8985580	0	40	0	1	41
3L	8987752	0	0	0	92	92
3L	8991591	0	28	0	0	28
3L	8993217	0	43	0	0	43
3L	8997822	0	18	0	0	18
3L	9100899	0	2	0	16	18
3L	9124178	0	0	0	5	5
3L	9124180	0	1	0	4	5
3L	9124570	0	0	0	2	2
3L	9144950	274	1	1	2	278
3L	9146324	43	0	0	0	43
3L	9147825	0	0	0	24	24
3L	9149081	0	4	0	26	30
3L	9151835	0	5	0	66	71
3L	9151836	0	0	0	76	76
3L	9155185	0	24	0	51	75
3L	9155218	0	69	0	3	72
3L	9161860	0	1	0	12	13
3L	9161861	0	1	0	10	11
3L	9161863	0	2	0	9	11
3L	9161864	0	0	0	15	15
3L	9161865	0	0	0	14	14
3L	9162917	0	28	0	37	65
3L	9162924	0	9	0	47	56
3L	9172898	0	0	1	0	1
3L	9258715	5	0	0	0	5
3L	9263686	0	2	0	0	2
3L	9270392	0	0	48	0	48
3L	9282077	0	0	0	0	0
3L	9287571	0	0	0	26	26
3L	9341681	10	0	0	0	10
3L	9378596	0	0	0	49	49
3L	9488590	0	5	0	0	5
3L	9497783	0	0	0	6	6
3L	9562249	0	0	0	0	0
3L	9566820	0	0	0	0	0
3L	9566821	0	0	0	0	0
3L	9587305	13	0	0	0	13
3L	9608849	0	2	0	0	2
3L	9622044	33	0	0	0	33
3L	9625888	0	0	6	0	6
3L	9631909	0	0	0	41	41
3L	9632368	0	0	0	167	167
3L	9633307	0	1	0	188	189
3L	9644938	21	0	0	0	21
3L	9645414	0	0	0	21	21
3L	9648209	0	0	0	0	0
3L	9649368	0	0	0	0	0
3L	9666680	0	0	0	0	0
3L	9668976	0	43	0	39	82
3L	9682712	0	0	2	0	2
3L	9682988	0	0	1	0	1
3L	9686533	0	0	0	53	53
3L	9688751	0	0	0	43	43
3L	9709045	0	0	155	0	155
3L	9717933	0	0	0	10	10
3L	9724380	0	0	0	8	8
3L	9724514	0	18	0	0	18
3L	9724607	15	0	0	0	15
3L	9730982	1599	0	0	0	1599
3L	9734333	0	0	0	207	207
3L	9736382	0	0	0	21	21
3L	9736627	0	1	0	12	13
3L	9738180	0	374	1	0	375
3L	9740249	0	17	0	0	17
3L	9740401	0	27	0	0	27
3L	9774568	0	0	1	0	1
3L	9799424	2	0	0	0	2
3L	9807026	0	0	0	0	0
3L	9814841	0	0	0	0	0
3L	9815342	0	0	1	0	1
3L	9816197	0	0	1	0	1
3L	9816249	0	2	0	0	2
3L	9816250	0	0	1	0	1
3L	9816252	0	0	2	0	2
3L	9816265	24	0	0	0	24
3L	9816267	0	0	29	0	29
3L	9817489	0	0	0	0	0
3L	9819018	0	0	0	0	0
3L	9821256	0	0	0	0	0
3L	9821464	0	4	0	0	4
3L	9821472	5	0	0	0	5
3L	9821474	5	0	0	0	5
3L	9821481	0	0	0	5	5
3L	9821685	0	0	0	13	13
3L	9833291	297	0	24	0	321
3L	9833294	234	0	109	0	343
3L	9833300	161	0	182	0	343
3L	9833301	119	0	225	0	344
3L	9833364	288	0	13	1	302
3L	9833369	69	0	236	0	305
3L	9833370	281	0	26	0	307
3L	9833459	194	0	95	0	289
3L	9833484	239	0	53	0	292
3L	9833487	262	0	24	0	286
3L	9867222	83	0	12	0	95
3L	9867339	82	0	113	0	195
3L	9885244	0	0	0	19	19
3L	9885764	0	0	0	11	11
3L	9886836	0	0	0	7	7
3L	9892134	37	0	22	0	59
3L	9943795	0	0	0	0	0
3L	9943907	0	0	0	0	0
3L	9972754	2	0	0	0	2
3L	9974737	13	0	0	0	13
3L	10023375	0	0	0	0	0
3L	10153722	0	0	0	4	4
3L	10182898	0	2	0	4	6
3L	10182954	0	3	0	3	6
3L	10185757	0	1	0	2	3
3L	10197944	0	0	0	0	0
3L	10287759	0	0	0	0	0
3L	10358012	0	0	0	0	0
3L	10423429	0	0	0	0	0
3L	10478991	0	0	0	0	0
3L	10516387	1	0	0	0	1
3L	10556226	1	0	0	0	1
3L	10583448	0	10	0	0	10
3L	10644076	0	0	90	0	90
3L	10659046	0	0	0	0	0
3L	10672257	0	0	0	0	0
3L	10785536	0	0	0	0	0
3L	10787010	0	0	0	0	0
3L	10787012	0	0	0	0	0
3L	10820249	0	0	0	0	0
3L	10848012	0	0	0	0	0
3L	10944093	0	0	0	0	0
3L	11038040	0	4	0	118	122
3L	11067981	17	0	0	0	17
3L	11073860	0	0	0	87	87
3L	11166174	0	12	0	0	12
3L	11166793	9	0	0	0	9
3L	11166799	0	0	0	9	9
3L	11166802	0	0	0	8	8
3L	11166932	0	0	0	14	14
3L	11175776	3	0	4	0	7
3L	11175795	5	0	2	0	7
3L	11175891	2	0	1	0	3
3L	11175895	2	0	1	0	3
3L	11175896	2	0	0	0	2
3L	11176183	1	0	2	0	3
3L	11176185	2	0	1	0	3
3L	11178469	0	0	171	0	171
3L	11203066	0	0	0	26	26
3L	11209891	0	0	30	0	30
3L	11211185	53	0	0	0	53
3L	11211200	51	0	0	0	51
3L	11218031	0	0	0	0	0
3L	11218035	0	0	0	0	0
3L	11218227	0	0	0	0	0
3L	11225111	93	0	0	0	93
3L	11225150	64	0	30	0	94
3L	11280036	0	0	0	0	0
3L	11519814	0	9	0	0	9
3L	11552592	0	2	0	4	6
3L	11553320	0	0	0	1	1
3L	11553330	0	0	0	1	1
3L	11553333	0	0	0	1	1
3L	11559570	0	0	0	1	1
3L	11599583	0	0	0	0	0
3L	11650023	0	0	0	68	68
3L	11670833	0	0	0	3	3
3L	11734662	0	14	0	72	86
3L	11746631	0	0	0	0	0
3L	11764981	0	0	0	0	0
3L	11803246	0	0	0	0	0
3L	11807770	0	0	0	0	0
3L	11815790	0	30	0	0	30
3L	11824846	17	0	0	0	17
3L	11827577	0	0	0	2	2
3L	11837250	0	0	0	0	0
3L	11837265	0	0	0	0	0
3L	11857720	0	0	0	1	1
3L	11857797	0	0	0	0	0
3L	11857887	0	0	1	0	1
3L	11857906	0	0	1	0	1
3L	11956759	0	0	0	0	0
3L	11964188	0	2	0	0	2
3L	11974542	0	0	0	0	0
3L	12022418	0	0	0	0	0
3L	12023402	0	0	0	0	0
3L	12066158	0	0	0	0	0
3L	12070965	0	19	0	0	19
3L	12100697	0	0	0	0	0
3L	12105494	0	0	0	0	0
3L	12123225	0	0	1	458	459
3L	12211671	0	63	0	39	102
3L	12211756	0	12	0	66	78
3L	12212148	0	98	0	3	101
3L	12212309	0	108	0	6	114
3L	12239964	0	0	0	0	0
3L	12244780	0	0	0	0	0
3L	12252166	0	0	0	0	0
3L	12297495	0	0	0	0	0
3L	12423647	0	0	0	0	0
3L	12426521	0	0	0	0	0
3L	12430208	0	0	0	0	0
3L	12440786	0	0	0	0	0
3L	12445033	0	0	0	0	0
3L	12463065	0	0	0	0	0
3L	12463742	0	0	12	0	12
3L	12471180	0	0	0	0	0
3L	12471570	0	0	0	0	0
3L	12493418	0	0	6	0	6
3L	12494398	2	0	0	0	2
3L	12508254	1	0	0	0	1
3L	12508840	0	0	0	3	3
3L	12509140	0	0	0	0	0
3L	12510503	0	0	0	0	0
3L	12519462	137	0	0	0	137
3L	12519598	142	0	0	0	142
3L	12524172	0	0	0	0	0
3L	12527022	0	0	0	0	0
3L	12529862	0	0	0	1	1
3L	12546839	0	0	0	0	0
3L	12691864	0	0	0	0	0
3L	12731393	0	0	0	0	0
3L	12731797	0	0	0	0	0
3L	12768257	27	0	0	0	27
3L	12826688	0	14	0	0	14
3L	12853773	0	0	123	1	124
3L	12856591	62	0	0	0	62
3L	13007953	0	1	0	0	1
3L	13020448	0	33	0	85	118
3L	13038438	25	0	27	0	52
3L	13194742	0	0	0	0	0
3L	13194835	0	0	0	0	0
3L	13195237	0	0	0	0	0
3L	13195308	0	0	0	0	0
3L	13196156	0	0	0	0	0
3L	13196212	0	0	0	0	0
3L	13218792	0	0	0	0	0
3L	13225212	0	0	0	0	0
3L	13309717	0	0	0	0	0
3L	13312105	0	0	0	0	0
3L	13312111	0	0	0	0	0
3L	13418107	0	0	0	6	6
3L	13435185	0	3	0	9	12
3L	13467599	0	107	0	0	107
3L	13467636	0	122	0	0	122
3L	13467653	0	122	0	0	122
3L	13480590	0	0	53	0	53
3L	13492027	0	0	0	0	0
3L	13494294	1	0	0	0	1
3L	13494298	2	0	0	0	2
3L	13494304	2	0	0	0	2
3L	13494305	0	0	2	0	2
3L	13494355	0	0	0	1	1
3L	13494364	1	0	0	0	1
3L	13494365	0	0	1	0	1
3L	13494372	0	2	0	0	2
3L	13494373	0	2	0	0	2
3L	13494374	2	0	0	0	2
3L	13494390	0	0	1	0	1
3L	13494392	0	1	0	0	1
3L	13494408	0	1	0	0	1
3L	13494438	2	0	0	0	2
3L	13494439	0	3	0	0	3
3L	13494441	3	0	0	0	3
3L	13494445	3	0	0	0	3
3L	13494448	2	0	0	0	2
3L	13494451	3	0	0	0	3
3L	13494457	0	0	3	0	3
3L	13494472	0	0	0	3	3
3L	13494497	2	0	0	0	2
3L	13494498	0	0	0	0	0
3L	13494519	0	2	0	0	2
3L	13494520	0	0	0	1	1
3L	13494596	0	0	6	0	6
3L	13494693	5	0	0	0	5
3L	13494842	0	0	23	0	23
3L	13502410	0	0	0	7	7
3L	13535416	0	0	23	0	23
3L	13600286	0	0	0	0	0
3L	13703883	0	0	0	0	0
3L	13858574	93	0	0	0	93
3L	13859907	0	0	34	0	34
3L	13869566	82	0	0	0	82
3L	13871006	0	0	0	13	13
3L	13888962	0	0	0	4	4
3L	13901738	0	0	0	56	56
3L	13912261	0	2	0	0	2
3L	13919434	0	0	0	11	11
3L	13927002	0	0	0	16	16
3L	13929952	21	0	10	0	31
3L	13933146	78	0	0	0	78
3L	13933176	81	0	0	0	81
3L	13959984	38	0	0	0	38
3L	13962782	0	0	0	3	3
3L	13967324	5	0	0	0	5
3L	13974178	40	0	0	0	40
3L	14000997	0	0	0	32	32
3L	14001118	0	0	0	32	32
3L	14063120	0	0	0	0	0
3L	14066713	71	0	0	0	71
3L	14070532	0	0	0	0	0
3L	14071510	0	0	0	8	8
3L	14084672	0	0	0	0	0
3L	14084674	0	0	0	0	0
3L	14090360	0	0	0	0	0
3L	14090416	0	0	0	0	0
3L	14090417	0	0	0	0	0
3L	14096104	0	0	0	0	0
3L	14096107	0	0	0	0	0
3L	14096112	0	0	0	0	0
3L	14096121	0	0	0	0	0
3L	14096133	0	0	0	0	0
3L	14096136	0	0	0	0	0
3L	14096146	0	0	0	0	0
3L	14097465	0	0	0	0	0
3L	14097466	0	0	0	0	0
3L	14097468	0	0	0	0	0
3L	14097688	0	2	0	0	2
3L	14097689	0	0	0	2	2
3L	14097845	0	0	0	0	0
3L	14097870	0	0	0	0	0
3L	14097874	0	0	0	0	0
3L	14098080	0	0	0	0	0
3L	14098096	0	0	0	0	0
3L	14098097	0	0	0	0	0
3L	14098360	0	0	0	0	0
3L	14098377	0	0	0	0	0
3L	14098378	0	0	0	0	0
3L	14098379	0	0	0	0	0
3L	14100722	0	0	0	0	0
3L	14100724	0	0	0	0	0
3L	14111714	0	0	0	0	0
3L	14112636	0	6	0	0	6
3L	14212209	0	0	56	0	56
3L	14227988	1	0	0	0	1
3L	14235297	0	0	0	0	0
3L	14236740	0	0	0	0	0
3L	14368016	12	0	0	0	12
3L	14426456	0	0	0	0	0
3L	14439493	0	0	0	0	0
3L	14755055	0	0	0	0	0
3L	14764947	57	0	0	0	57
3L	14799253	33	0	3	0	36
3L	14862538	0	0	0	0	0
3L	14882352	0	0	0	0	0
3L	15043222	0	0	0	0	0
3L	15102878	3	0	0	0	3
3L	15102879	0	0	0	3	3
3L	15102886	3	0	0	0	3
3L	15102895	0	0	0	3	3
3L	15102896	3	0	0	0	3
3L	15102897	0	0	0	3	3
3L	15102934	0	0	0	3	3
3L	15102939	3	0	0	0	3
3L	15472441	0	0	0	0	0
3L	15517405	0	0	0	0	0
3L	15532890	0	0	0	0	0
3L	15555171	1	0	0	0	1
3L	15658259	0	0	0	0	0
3L	15658274	0	0	0	0	0
3L	15659522	0	0	0	0	0
3L	15757800	0	0	0	0	0
3L	15893762	0	0	0	25	25
3L	15895755	0	0	0	1	1
3L	16052231	1	0	0	0	1
3L	16111589	0	24	0	79	103
3L	16181016	0	0	0	0	0
3L	16181038	0	0	0	0	0
3L	16181052	0	0	0	0	0
3L	16181053	0	0	0	0	0
3L	16181094	0	0	0	0	0
3L	16182056	0	0	0	0	0
3L	16182169	0	0	0	0	0
3L	16182170	0	0	0	0	0
3L	16186140	0	0	0	0	0
3L	16186145	0	0	0	0	0
3L	16186363	0	0	0	0	0
3L	16254434	0	0	0	0	0
3L	16254435	0	0	0	0	0
3L	16255064	1	0	0	0	1
3L	16255072	0	0	1	0	1
3L	16262552	0	0	0	0	0
3L	16270810	0	0	0	0	0
3L	16291947	0	0	0	0	0
3L	16577155	0	0	0	4	4
3L	16616020	19	0	0	0	19
3L	16616021	0	0	0	19	19
3L	16617760	0	0	0	0	0
3L	16642757	0	0	0	0	0
3L	16645041	0	0	0	0	0
3L	16674672	0	0	0	0	0
3L	16678530	0	123	0	0	123
3L	16686521	0	0	0	0	0
3L	16688610	0	0	0	0	0
3L	16692734	0	0	0	0	0
3L	16728214	0	0	0	0	0
3L	16731471	0	0	0	0	0
3L	16736878	0	0	0	0	0
3L	16758529	0	0	1	0	1
3L	16786895	132	0	0	0	132
3L	16786980	0	0	0	0	0
3L	16908885	0	0	1	0	1
3L	16910270	0	0	3	0	3
3L	16968101	0	0	0	371	371
3L	17075627	0	4	0	1	5
3L	17378242	0	0	0	0	0
3L	17389187	0	0	0	0	0
3L	17425746	0	0	3	0	3
3L	17451133	10	0	0	0	10
3L	17475161	4	0	0	0	4
3L	17597746	0	22	0	0	22
3L	17668401	0	0	0	7	7
3L	17689993	0	0	0	1	1
3L	17726464	0	0	0	0	0
3L	17742206	0	0	0	1	1
3L	17951569	74	0	0	0	74
3L	17979662	0	0	0	0	0
3L	17979744	0	0	0	0	0
3L	18027635	0	0	0	0	0
3L	18087658	0	0	0	0	0
3L	18090225	0	0	0	0	0
3L	18132571	0	0	0	1	1
3L	18181206	0	0	0	0	0
3L	18189120	0	0	0	0	0
3L	18281392	0	0	0	0	0
3L	18281522	0	0	0	0	0
3L	18555038	0	0	0	0	0
3L	18596316	0	1	0	0	1
3L	18670895	0	0	0	85	85
3L	18682575	19	0	0	0	19
3L	18685220	0	0	0	39	39
3L	18685424	0	0	0	44	44
3L	18728861	0	0	0	0	0
3L	18800841	25	0	0	0	25
3L	18819562	0	0	0	14	14
3L	18878588	0	0	0	167	167
3L	18878936	0	0	0	378	378
3L	18897569	0	0	0	5	5
3L	18922609	0	10	0	0	10
3L	18922733	0	11	0	0	11
3L	19052915	0	0	0	0	0
3L	19055200	0	0	0	0	0
3L	19066432	0	0	0	22	22
3L	19067899	0	0	0	28	28
3L	19070611	0	1	0	0	1
3L	19106047	0	1	0	18	19
3L	19110288	0	41	0	0	41
3L	19147008	0	0	0	0	0
3L	19160049	0	0	0	0	0
3L	19283200	0	9	0	132	141
3L	19283264	0	55	0	106	161
3L	19283265	0	15	0	142	157
3L	19341568	0	0	0	31	31
3L	19369627	0	0	0	0	0
3L	19371398	0	0	0	0	0
3L	19399656	0	0	0	1	1
3L	19411978	0	0	0	0	0
3L	19501470	0	0	0	0	0
3L	19513044	0	0	0	0	0
3L	19516477	0	0	0	0	0
3L	19531391	0	0	0	0	0
3L	19542365	0	0	0	59	59
3L	19545728	0	0	4	0	4
3L	19578009	0	2	0	0	2
3L	19618855	0	0	0	0	0
3L	19689767	1171	0	158	0	1329
3L	19689870	120	0	719	0	839
3L	19689871	16	0	805	0	821
3L	19932956	0	0	0	0	0
3L	20035022	0	0	0	0	0
3L	20098494	0	0	0	113	113
3L	20156776	0	6	0	10	16
3L	20156958	0	13	0	15	28
3L	20252103	1	0	6	0	7
3L	20353020	0	0	0	22	22
3L	20379678	43	0	16	0	59
3L	20391933	0	0	0	8	8
3L	20420837	0	2	0	0	2
3L	20427294	0	0	0	13	13
3L	20428234	0	0	0	19	19
3L	20453518	0	0	0	0	0
3L	20465542	0	0	0	0	0
3L	20502571	0	0	0	0	0
3L	20502628	2	0	0	0	2
3L	20503418	1	0	0	0	1
3L	20523500	0	29	0	55	84
3L	20598406	0	16	0	0	16
3L	20598874	0	0	0	18	18
3L	20690411	0	0	0	0	0
3L	20768391	0	16	0	0	16
3L	20773150	56	0	140	0	196
3L	20773190	56	0	114	0	170
3L	20773546	187	0	20	1	208
3L	20773569	181	0	59	0	240
3L	20773589	181	0	34	0	215
3L	20773609	169	0	43	0	212
3L	20773610	154	0	65	0	219
3L	20802315	1	0	0	0	1
3L	20817830	0	0	0	4	4
3L	20820474	0	0	35	0	35
3L	20867520	0	0	0	0	0
3L	20879740	0	0	0	0	0
3L	20885034	0	87	0	0	87
3L	20942629	0	0	0	0	0
3L	20975576	0	0	0	0	0
3L	21072555	157	0	0	0	157
3L	21115651	1	0	0	0	1
3L	21118999	0	0	0	0	0
3L	21130550	0	0	0	1	1
3L	21130556	1	0	0	0	1
3L	21130559	0	0	0	1	1
3L	21130564	0	0	0	0	0
3L	21130610	0	0	0	0	0
3L	21130611	0	0	0	0	0
3L	21130618	0	0	0	0	0
3L	21130621	0	0	0	0	0
3L	21164936	0	0	0	0	0
3L	21179937	0	90	0	0	90
3L	21195648	0	0	0	1	1
3L	21203253	37	0	4	0	41
3L	21204995	7	0	0	0	7
3L	21205002	7	0	0	0	7
3L	21207897	52	0	10	0	62
3L	21210325	66	0	0	0	66
3L	21213292	55	0	37	0	92
3L	21226173	0	0	0	0	0
3L	21309631	0	1	0	0	1
3L	21333937	24	0	41	0	65
3L	21390253	0	0	0	0	0
3L	21390256	0	0	0	0	0
3L	21390260	0	0	0	0	0
3L	21390271	0	0	0	0	0
3L	21390275	0	0	0	0	0
3L	21390282	0	0	0	0	0
3L	21390294	0	0	0	0	0
3L	21390295	0	0	0	0	0
3L	21390303	0	0	0	0	0
3L	21390314	0	0	0	0	0
3L	21391007	0	0	0	0	0
3L	21391234	0	0	0	0	0
3L	21391240	0	0	0	0	0
3L	21644394	0	0	0	0	0
3L	21644396	0	0	0	0	0
3L	21644402	0	0	0	0	0
3L	21696292	0	0	0	0	0
3L	21696294	0	0	0	0	0
3L	21696345	0	0	0	0	0
3L	21696349	0	0	0	0	0
3L	21696352	0	0	0	0	0
3L	21696354	0	0	0	0	0
3L	21696356	0	0	0	0	0
3L	21696357	0	0	0	0	0
3L	21696361	0	0	0	0	0
3L	21696364	0	0	0	0	0
3L	21696375	0	0	0	0	0
3L	21696397	0	0	0	0	0
3L	21696400	0	0	0	0	0
3L	21696404	0	0	0	0	0
3L	21696405	0	0	0	0	0
3L	21696410	0	0	0	0	0
3L	21714311	0	0	0	0	0
3L	21715425	0	0	0	0	0
3L	21717050	0	0	0	0	0
3L	21728957	4	0	0	0	4
3L	21845812	0	0	0	0	0
3L	22132252	0	0	0	0	0
3L	22133068	0	0	0	0	0
3L	22133070	0	0	0	0	0
3L	22169386	0	0	0	0	0
3L	22268084	4	0	2	0	6
3L	22273143	424	0	41	0	465
3L	22273144	454	0	11	0	465
3L	22463672	0	0	0	2	2
3L	22655901	0	0	0	0	0
3L	22731262	2	0	0	0	2
3L	22793765	0	0	0	13	13
3L	22826560	2	0	0	0	2
3L	22827988	2	0	0	0	2
3L	22894950	0	0	0	0	0
3L	22894959	0	0	0	0	0
3L	23022502	24	0	5	0	29
3L	23022517	18	0	9	0	27
3L	23022531	23	0	4	0	27
3L	23022558	20	0	10	0	30
3L	23022565	20	0	10	0	30
3L	23022570	8	0	21	0	29
3L	23022589	13	0	15	0	28
3L	23022624	10	1	7	0	18
3L	23022651	8	0	3	0	11
3L	23022665	7	0	5	0	12
3L	23022696	6	0	5	0	11
3L	23022733	5	0	6	0	11
3L	23022747	7	0	5	0	12
3L	23022860	14	0	1	0	15
3L	23022915	17	0	1	0	18
3L	23023572	20	0	0	0	20
3L	23023737	9	0	3	0	12
3L	23023745	9	0	2	0	11
3L	23023746	11	0	1	0	12
3L	23023752	2	0	5	0	7
3L	23023759	4	0	3	0	7
3L	23023768	2	0	5	0	7
3L	23023772	2	0	6	0	8
3L	23023773	4	0	3	0	7
3L	23023776	3	0	5	0	8
3L	23023778	4	0	4	0	8
3L	23034648	13	1	40	1	55
3L	23035386	68	0	7	0	75
3L	23035498	39	0	11	0	50
3L	23035510	22	0	28	0	50
3L	23036047	55	0	9	0	64
3L	23036053	23	0	42	0	65
3L	23036055	55	0	10	0	65
3L	23036058	1	0	65	0	66
3L	23036059	38	0	29	0	67
3L	23036066	17	0	50	0	67
3L	23036068	36	0	31	0	67
3L	23036071	1	0	67	0	68
3L	23036082	59	0	11	0	70
3L	23036083	66	0	6	0	72
3L	23036084	65	0	6	0	71
3L	23036087	62	0	7	0	69
3L	23036098	55	0	7	0	62
3L	23036101	60	0	6	0	66
3L	23036116	45	1	35	0	81
3L	23036121	64	0	18	0	82
3L	23036453	44	0	15	0	59
3L	23036548	17	0	31	0	48
3L	23036588	23	0	26	0	49
3L	23036631	24	0	40	0	64
3L	23216253	0	0	0	0	0
3L	23228909	3	0	0	0	3
3L	23228910	3	0	0	0	3
3L	23228912	3	0	0	0	3
3L	23228932	2	0	0	0	2
3L	23231321	1	0	0	0	1
3L	23232223	3	0	0	0	3
3L	23241819	3	0	0	0	3
3L	23252714	0	0	0	0	0
3L	23284872	40	0	3	0	43
3L	23286473	97	0	10	0	107
3L	23286550	101	0	19	0	120
3L	23579149	0	0	0	0	0
3L	23742459	4	0	14	0	18
3L	23743265	18	0	0	0	18
3L	23743306	12	0	1	0	13
3L	23796662	1	0	0	0	1
3L	24031604	24	0	7	0	31
3L	24031889	11	0	15	0	26
3L	24031891	13	0	12	0	25
3L	24040526	0	0	0	0	0
3L	24074572	0	0	0	0	0
3L	24074586	0	0	0	0	0
3L	24074603	0	0	0	0	0
3L	24074606	0	0	0	0	0
3L	24074610	0	0	0	0	0
3L	24074617	0	0	0	0	0
3L	24074621	0	0	0	0	0
3L	24074625	0	0	0	0	0
3L	24074665	0	0	0	0	0
3L	24074669	0	0	0	0	0
3L	24074673	0	0	0	0	0
3L	24074677	0	0	0	0	0
3L	24074679	0	0	0	0	0
3L	24074680	0	0	0	0	0
3L	24074682	0	0	0	0	0
3L	24074685	0	0	0	0	0
3L	24074697	0	0	0	0	0
3L	24074700	0	0	0	0	0
3L	24074710	0	0	0	0	0
3L	24074713	0	0	0	0	0
3L	24074747	0	0	0	0	0
3L	24074754	0	0	0	0	0
3L	24074759	0	0	0	0	0
3L	24074986	0	0	0	0	0
3L	24184343	0	0	0	0	0
3L	24184352	0	0	0	0	0
3L	24260884	0	0	0	0	0
3L	24539756	4	0	1	0	5
3L	24574446	0	0	0	0	0
3L	24727794	1	0	1	0	2
3L	24729192	0	0	0	0	0
3L	24729203	0	0	0	0	0
3L	24729209	0	0	0	0	0
3L	24729558	1	0	0	0	1
3L	24734394	0	0	0	0	0
3L	24734409	0	0	0	0	0
3L	24734433	0	0	0	0	0
3L	24734434	0	0	0	0	0
3L	24734444	0	0	0	0	0
3L	24734445	0	0	0	0	0
3L	24734544	0	0	0	0	0
3L	24734545	0	0	0	0	0
3L	24734548	0	0	0	0	0
3L	24734549	0	0	0	0	0
3L	24734550	0	0	0	0	0
3L	24734565	0	0	0	0	0
3L	24734583	0	0	0	0	0
3L	24739737	0	0	0	0	0
3L	24739770	0	0	0	0	0
3L	24739940	0	0	0	0	0
3L	24739953	0	0	0	0	0
3L	25191188	0	0	0	0	0
3L	25404612	0	0	0	1	1
3L	25411101	0	0	0	0	0
3L	25440130	0	0	0	0	0
3L	25487370	0	0	0	0	0
3L	25519478	0	0	0	0	0
3L	25519484	0	0	0	0	0
3L	25519485	0	0	0	0	0
3L	25519514	0	0	0	0	0
3L	25519515	0	0	0	0	0
3L	25519516	0	0	0	0	0
3L	25519519	0	0	0	0	0
3L	25519523	0	0	0	0	0
3L	25519524	0	0	0	0	0
3L	25598311	0	1	0	0	1
3L	25608424	0	0	0	2	2
3L	25608425	0	0	0	2	2
3L	25608436	0	1	0	1	2
3L	25633906	0	1	0	28	29
3L	25633926	0	1	0	27	28
3L	25668383	0	0	0	0	0
3L	25668389	0	0	0	0	0
3L	25668390	0	0	0	0	0
3L	25668438	0	0	0	0	0
3L	25668442	0	0	0	0	0
3L	25668450	0	0	0	0	0
3L	25668451	0	0	0	0	0
3L	25668452	0	0	0	0	0
3L	25668462	0	0	0	0	0
3L	25668464	0	0	0	0	0
3L	25668466	0	0	0	0	0
3L	25668467	0	0	0	0	0
3L	25668501	0	0	0	0	0
3L	25668503	0	0	0	0	0
3L	25668653	0	0	0	0	0
3L	25669834	0	1	0	1	2
3L	25669886	0	0	0	2	2
3L	25669903	0	1	0	1	2
3L	25669904	0	0	0	2	2
3L	25669929	0	2	0	0	2
3L	25669935	0	0	0	1	1
3L	25674685	1	0	2	0	3
3L	25674703	0	0	2	0	2
3L	25674878	1	0	2	0	3
3L	25849333	0	0	0	0	0
3L	25873801	0	0	0	0	0
3L	25920861	0	0	0	0	0
3L	26001042	0	5	0	2	7
3L	26002127	0	1	0	14	15
3L	26002138	0	0	0	14	14
3L	26002140	0	0	0	12	12
3L	26002728	0	0	0	6	6
3L	26003264	0	1	0	9	10
3L	26009778	0	0	0	0	0
3L	26009830	0	1	0	0	1
3L	26012760	0	0	0	1	1
3L	26012768	0	0	0	0	0
3L	26582674	0	0	0	0	0
3L	26594673	0	0	0	0	0
3L	26610401	0	0	0	0	0
3L	26666453	0	0	0	0	0
3L	26667951	0	0	0	0	0
3L	26756592	0	0	0	0	0
3L	27281127	3	0	1	0	4
3L	27281185	4	0	0	0	4
3L	27845559	0	0	0	0	0
3L	27845560	0	0	0	0	0
3L	27845708	0	0	0	0	0
3L	28002470	0	1	0	0	1
3L	28002543	0	0	0	0	0
3L	28002555	0	0	0	0	0
3L	28002560	0	0	0	0	0
3L	28002748	0	2	0	0	2
3L	28002752	0	2	0	0	2
3R	2156963	0	0	0	0	0
3R	3122736	0	0	0	0	0
3R	3122737	0	0	0	0	0
3R	3751950	2	0	1	0	3
3R	4131662	1	0	0	0	1
3R	4185912	34	0	6	0	40
3R	4185926	22	0	19	0	41
3R	4185927	22	0	21	0	43
3R	4185928	40	0	6	0	46
3R	4186013	32	0	5	0	37
3R	4186020	31	0	2	0	33
3R	4186021	30	0	4	0	34
3R	4186029	33	0	1	0	34
3R	4186038	37	0	2	0	39
3R	4186053	29	0	6	0	35
3R	4186057	31	0	3	0	34
3R	4186060	31	0	3	0	34
3R	4186071	31	0	1	0	32
3R	4186077	31	0	0	0	31
3R	4186090	31	0	2	0	33
3R	4186091	20	0	12	0	32
3R	4279033	0	11	0	14	25
3R	4279036	0	15	0	12	27
3R	4279126	0	17	0	9	26
3R	4279127	0	18	0	10	28
3R	4279128	0	16	0	12	28
3R	4297057	92	0	21	0	113
3R	4297067	110	0	3	0	113
3R	4297086	108	0	2	0	110
3R	4297093	114	0	4	0	118
3R	4297095	109	0	9	0	118
3R	4297504	831	1	544	0	1376
3R	4297517	1063	0	226	0	1289
3R	4297518	922	0	371	0	1293
3R	4299218	206	0	25	0	231
3R	4299387	175	0	28	0	203
3R	4299391	130	0	61	0	191
3R	4301117	97	0	14	0	111
3R	4301124	111	0	2	0	113
3R	4301140	69	0	26	0	95
3R	4301142	76	0	24	0	100
3R	4301144	89	0	9	0	98
3R	4301150	56	0	42	0	98
3R	4301158	91	0	19	0	110
3R	4301166	110	0	13	0	123
3R	4301174	129	0	9	1	139
3R	4301182	129	0	20	0	149
3R	4301190	110	0	32	0	142
3R	4301192	121	0	21	1	143
3R	4301196	125	0	20	1	146
3R	4301198	109	0	33	0	142
3R	4301200	116	0	27	0	143
3R	4301206	111	0	33	0	144
3R	4301208	107	0	35	0	142
3R	4301212	107	0	40	0	147
3R	4301214	125	0	22	0	147
3R	4301216	132	0	15	0	147
3R	4301240	114	0	23	0	137
3R	4301244	110	0	25	0	135
3R	4301246	105	0	31	0	136
3R	4301248	130	0	17	0	147
3R	4301250	125	0	22	0	147
3R	4301252	142	0	21	0	163
3R	4301254	161	0	29	0	190
3R	4301258	137	0	54	0	191
3R	4365384	114	0	146	0	260
3R	4365385	13	0	248	0	261
3R	4365474	127	0	144	0	271
3R	4493894	0	3	0	16	19
3R	4656505	33	0	16	0	49
3R	4702574	22	0	13	0	35
3R	4944773	4	0	0	0	4
3R	4965472	74	0	0	0	74
3R	5084900	0	0	0	115	115
3R	5236209	0	0	0	336	336
3R	5236328	0	0	0	0	0
3R	5236329	0	0	0	0	0
3R	5236332	0	0	0	0	0
3R	5236375	0	0	1	543	544
3R	5236378	0	0	0	552	552
3R	5260897	0	0	0	0	0
3R	5260900	0	0	0	0	0
3R	5260901	0	0	0	0	0
3R	5260908	0	0	0	0	0
3R	5260909	0	0	0	0	0
3R	5260910	0	0	0	0	0
3R	5260911	0	0	0	0	0
3R	5260913	0	0	0	0	0
3R	5260914	0	0	0	0	0
3R	5260918	0	0	0	0	0
3R	5260923	0	0	0	0	0
3R	5260926	0	0	0	0	0
3R	5260929	0	0	0	0	0
3R	5260930	0	0	0	0	0
3R	5260931	0	0	0	0	0
3R	5260932	0	0	0	0	0
3R	5260940	0	0	0	0	0
3R	5260941	0	0	0	0	0
3R	5260944	0	0	0	0	0
3R	5260945	0	0	0	0	0
3R	5260946	0	0	0	0	0
3R	5260947	0	0	0	0	0
3R	5260948	0	0	0	0	0
3R	5260949	0	0	0	0	0
3R	5260954	0	0	0	0	0
3R	5260956	0	0	0	0	0
3R	5260957	0	0	0	0	0
3R	5260958	0	0	0	0	0
3R	5260960	0	0	0	0	0
3R	5260961	0	0	0	0	0
3R	5260962	0	0	0	0	0
3R	5260963	0	0	0	0	0
3R	5260964	0	0	0	0	0
3R	5260965	0	0	0	0	0
3R	5260968	0	0	0	0	0
3R	5260969	0	0	0	0	0
3R	5260970	0	0	0	0	0
3R	5260971	0	0	0	0	0
3R	5260972	0	0	0	0	0
3R	5260973	0	0	0	0	0
3R	5260974	0	0	0	0	0
3R	5260976	0	0	0	0	0
3R	5260981	0	0	0	0	0
3R	5260982	0	0	0	0	0
3R	5260984	0	0	0	0	0
3R	5260985	0	0	0	0	0
3R	5260986	0	0	0	0	0
3R	5260987	0	0	0	0	0
3R	5260992	0	0	0	0	0
3R	5260993	0	0	0	0	0
3R	5260994	0	0	0	0	0
3R	5260995	0	0	0	0	0
3R	5260998	0	0	0	0	0
3R	5261005	0	0	0	0	0
3R	5261038	0	0	0	0	0
3R	5261039	0	0	0	0	0
3R	5261045	0	0	0	0	0
3R	5261046	0	0	0	0	0
3R	5261050	0	0	0	0	0
3R	5261052	0	0	0	0	0
3R	5261064	0	0	0	0	0
3R	5261070	0	0	0	0	0
3R	5261071	0	0	0	0	0
3R	5261073	0	0	0	0	0
3R	5268529	5	0	13	0	18
3R	5331180	0	1	0	2	3
3R	5456078	32	0	69	0	101
3R	5510248	1	7	0	57	65
3R	5512061	0	20	0	56	76
3R	5512062	0	15	0	59	74
3R	5579358	20	0	0	0	20
3R	5650231	52	0	50	0	102
3R	5650351	89	0	86	0	175
3R	5686487	5	0	1	0	6
3R	5794759	14	0	0	0	14
3R	5813914	0	0	0	17	17
3R	5835138	11	0	0	0	11
3R	6004380	0	217	0	407	624
3R	6198321	0	0	0	0	0
3R	6410404	0	0	0	0	0
3R	6454240	0	23	0	0	23
3R	6455990	0	6	0	23	29
3R	6456079	0	26	0	0	26
3R	6481790	0	0	0	2	2
3R	6482470	8	0	0	0	8
3R	6483189	0	0	0	0	0
3R	6646984	0	0	25	2	27
3R	6656412	0	0	0	38	38
3R	6825353	0	7	0	9	16
3R	7192775	46	0	229	0	275
3R	7192825	241	0	40	0	281
3R	7472957	0	0	0	2	2
3R	7474763	0	49	0	90	139
3R	7523172	0	0	0	1	1
3R	7527658	0	0	0	0	0
3R	7541970	1	0	0	0	1
3R	7541971	1	0	0	0	1
3R	7578932	0	0	0	0	0
3R	7632065	0	0	0	0	0
3R	7633948	0	0	0	2	2
3R	7857376	0	0	0	0	0
3R	7860890	0	3	0	32	35
3R	7886440	0	6	0	29	35
3R	7959962	0	0	0	0	0
3R	7975631	0	0	0	296	296
3R	8023269	0	34	0	124	158
3R	8025032	0	144	1	0	145
3R	8237633	0	0	0	24	24
3R	8380051	0	4	0	17	21
3R	8380439	0	19	0	18	37
3R	8380442	0	10	0	28	38
3R	8385971	0	35	0	0	35
3R	8386738	0	7	0	18	25
3R	8386758	0	4	0	20	24
3R	8658956	0	0	0	0	0
3R	8659112	0	0	0	2	2
3R	8661419	0	0	0	121	121
3R	8678362	0	0	25	0	25
3R	8736376	0	8	0	33	41
3R	8737810	0	14	0	28	42
3R	8775615	0	1	0	611	612
3R	8788015	0	0	0	0	0
3R	8788344	0	0	0	1	1
3R	8791608	0	1	0	0	1
3R	8795508	0	0	0	0	0
3R	8812828	0	0	0	7	7
3R	8834533	0	0	0	169	169
3R	8836915	0	48	0	25	73
3R	8836926	0	53	0	26	79
3R	8836929	0	45	0	32	77
3R	8837184	0	78	0	22	100
3R	8837191	0	79	0	28	107
3R	8837610	0	71	0	35	106
3R	8851870	0	0	0	1	1
3R	8864798	0	62	0	0	62
3R	8864972	0	0	0	66	66
3R	8867172	0	0	0	1	1
3R	8922284	0	0	0	0	0
3R	8937081	0	0	0	0	0
3R	8952096	0	0	0	0	0
3R	8992964	2	0	0	0	2
3R	9092757	0	0	0	4	4
3R	9094689	0	0	0	4	4
3R	9120444	0	0	0	12	12
3R	9134740	0	0	0	2	2
3R	9147309	0	0	0	3	3
3R	9192083	0	0	0	3	3
3R	9192878	0	0	0	3	3
3R	9195940	0	0	0	0	0
3R	9350774	1	0	0	0	1
3R	9354339	0	0	0	0	0
3R	9385249	0	0	0	1	1
3R	9394121	0	3	0	1	4
3R	9418495	6	0	0	0	6
3R	9418834	10	0	1	0	11
3R	9419410	12	0	2	0	14
3R	9419457	5	0	5	0	10
3R	9421085	0	0	1	0	1
3R	9428183	3	0	0	0	3
3R	9428227	2	0	2	0	4
3R	9428853	1	0	3	0	4
3R	9430861	2	0	4	0	6
3R	9430877	3	0	3	0	6
3R	9448522	198	0	28	0	226
3R	9451570	154	0	0	0	154
3R	9451939	137	0	56	0	193
3R	9455622	0	0	0	18	18
3R	9465643	0	0	0	59	59
3R	9492559	0	0	0	2	2
3R	9525980	0	0	93	0	93
3R	9544703	0	0	0	18	18
3R	9544820	0	4	0	9	13
3R	9591515	33	0	1	0	34
3R	9591859	26	0	0	0	26
3R	9614889	0	0	0	0	0
3R	9666847	0	1	0	0	1
3R	9721112	0	69	0	0	69
3R	9727213	0	43	0	0	43
3R	9729053	0	0	0	79	79
3R	9754511	0	0	0	9	9
3R	9761125	44	0	0	0	44
3R	9769425	78	0	54	0	132
3R	9798395	0	110	0	0	110
3R	9965066	0	0	0	0	0
3R	10029831	0	0	0	0	0
3R	10083460	2	0	0	0	2
3R	10097183	6	0	0	0	6
3R	10194903	36	0	12	0	48
3R	10194972	24	0	16	0	40
3R	10194990	25	0	16	0	41
3R	10195423	238	0	43	1	282
3R	10195426	11	0	267	0	278
3R	10195571	64	0	0	0	64
3R	10195983	171	0	96	0	267
3R	10195984	105	0	163	0	268
3R	10227022	8	0	3	0	11
3R	10228870	76	0	0	0	76
3R	10245424	92	0	35	0	127
3R	10245425	37	0	91	0	128
3R	10305770	50	0	0	0	50
3R	10333913	11	0	0	0	11
3R	10372369	0	0	0	19	19
3R	10391255	9	0	0	0	9
3R	10392923	6	0	0	0	6
3R	10393067	9	0	0	0	9
3R	10394318	20	0	0	0	20
3R	10515812	0	0	0	2	2
3R	10558186	0	0	0	1	1
3R	10584920	0	18	0	54	72
3R	10585180	0	13	0	26	39
3R	10585186	0	14	0	27	41
3R	10766619	14	0	0	0	14
3R	10768515	0	14	0	115	129
3R	10776609	0	0	0	0	0
3R	10782974	0	0	0	47	47
3R	10871792	0	0	0	288	288
3R	11127820	0	0	0	147	147
3R	11193273	0	0	0	0	0
3R	11398476	17	0	13	0	30
3R	11398478	23	0	4	0	27
3R	11450201	0	2	0	0	2
3R	11589338	0	0	0	58	58
3R	11765112	0	6	0	45	51
3R	11801192	0	44	0	57	101
3R	11951530	133	0	57	0	190
3R	11951562	110	0	72	0	182
3R	11953544	290	0	0	0	290
3R	11985293	0	0	0	442	442
3R	11989608	0	0	0	6	6
3R	11994674	0	127	0	0	127
3R	12079394	0	0	0	11	11
3R	12079473	0	0	0	9	9
3R	12096226	13	0	0	0	13
3R	12163774	1	712	0	0	713
3R	12164347	0	162	0	422	584
3R	12215148	7	0	0	0	7
3R	12283052	0	0	0	0	0
3R	12411087	0	0	92	0	92
3R	12416318	35	0	0	0	35
3R	12516932	0	13	0	23	36
3R	12593574	0	2	0	18	20
3R	12593953	0	3	0	14	17
3R	12594802	0	1	0	13	14
3R	12705537	0	0	0	0	0
3R	12741372	0	0	0	0	0
3R	13004750	0	0	70	0	70
3R	13004828	0	0	92	0	92
3R	13018291	0	0	4	0	4
3R	13373289	0	0	0	699	699
3R	13382634	0	0	2	0	2
3R	13399579	0	0	0	268	268
3R	13462029	76	0	0	0	76
3R	13528966	0	0	0	0	0
3R	13663586	251	0	0	0	251
3R	13692592	53	0	60	1	114
3R	13692593	93	0	20	0	113
3R	13725311	0	0	0	0	0
3R	13782016	0	0	3	0	3
3R	13782327	0	0	0	0	0
3R	13959841	398	0	0	0	398
3R	13993445	0	0	0	1	1
3R	14105598	0	31	0	0	31
3R	14108210	0	0	0	12	12
3R	14128425	0	0	71	0	71
3R	14330746	0	49	0	0	49
3R	14363401	0	0	0	0	0
3R	14363405	0	0	0	0	0
3R	14395408	0	57	0	0	57
3R	14409075	0	48	0	0	48
3R	14515193	0	4	0	67	71
3R	14522391	828	0	0	0	828
3R	14623285	0	0	0	64	64
3R	14735962	0	0	0	2	2
3R	14746231	0	0	1	125	126
3R	14746547	0	0	0	232	232
3R	14747108	0	0	0	167	167
3R	14788816	83	0	0	0	83
3R	14809014	0	4	0	0	4
3R	14880381	12	0	0	0	12
3R	14891090	1414	0	0	0	1414
3R	14903154	0	3	0	0	3
3R	14919312	0	0	22	0	22
3R	14996135	0	0	0	0	0
3R	15097165	0	10	0	77	87
3R	15099803	0	0	0	105	105
3R	15287927	0	0	0	0	0
3R	15288163	12	0	0	0	12
3R	15294740	13	0	1	0	14
3R	15296683	641	0	14	0	655
3R	15296695	617	0	4	0	621
3R	15297732	5	0	3	0	8
3R	15298760	7	0	0	0	7
3R	15306860	9	0	0	0	9
3R	15306861	8	0	1	0	9
3R	15384375	7	0	1	0	8
3R	15387222	92	0	65	0	157
3R	15388396	70	0	83	0	153
3R	15392578	161	0	0	0	161
3R	15399446	70	0	95	0	165
3R	15400137	17	0	0	0	17
3R	15400209	8	0	2	0	10
3R	15400211	11	0	0	0	11
3R	15400224	0	0	5	0	5
3R	15401498	0	0	0	132	132
3R	15413254	65	0	110	0	175
3R	15413305	80	0	115	0	195
3R	15413827	213	0	0	0	213
3R	15822468	136	0	23	0	159
3R	15950619	0	0	0	4	4
3R	16003657	64	0	0	0	64
3R	16045954	0	0	0	10	10
3R	16065967	0	2	0	1	3
3R	16087664	0	0	0	1	1
3R	16096668	0	99	0	47	146
3R	16097238	0	44	0	81	125
3R	16302773	17	0	11	0	28
3R	16302775	19	0	10	0	29
3R	16303403	50	0	6	0	56
3R	16303415	52	0	8	0	60
3R	16502786	15	0	0	0	15
3R	16591505	0	0	0	2	2
3R	16633290	131	0	16	0	147
3R	16633369	47	0	48	0	95
3R	16809936	0	0	0	1	1
3R	16827828	0	0	0	0	0
3R	17140246	0	0	0	0	0
3R	17149369	0	0	0	19	19
3R	17502097	0	0	0	0	0
3R	17544578	85	0	44	0	129
3R	17544743	87	0	31	0	118
3R	17750942	0	0	0	7	7
3R	17750957	0	6	0	4	10
3R	17770919	0	0	0	58	58
3R	17771810	0	0	0	75	75
3R	17772922	0	0	0	113	113
3R	17773982	0	15	0	3	18
3R	17774217	0	50	0	11	61
3R	17774401	29	0	0	0	29
3R	17774920	0	1	0	5	6
3R	17775731	0	0	0	24	24
3R	17778660	0	0	0	8	8
3R	17795473	33	0	0	0	33
3R	17796092	12	0	0	0	12
3R	17796780	0	0	0	61	61
3R	17797297	0	0	0	52	52
3R	17799317	0	0	0	12	12
3R	17808359	0	0	0	25	25
3R	17809478	0	0	0	3	3
3R	17852526	39	0	0	0	39
3R	17865673	53	0	0	0	53
3R	17873639	0	69	0	82	151
3R	17874391	0	0	0	140	140
3R	17877415	0	0	0	129	129
3R	17881420	0	106	0	42	148
3R	17881807	0	0	0	165	165
3R	17882765	0	55	0	6	61
3R	17897257	0	3	0	7	10
3R	17905164	0	0	0	49	49
3R	17905999	0	0	0	37	37
3R	17908804	38	0	0	0	38
3R	17938630	0	0	0	0	0
3R	17944246	21	0	0	0	21
3R	17945071	1	0	0	0	1
3R	17945344	5	0	0	0	5
3R	17945752	2	0	0	0	2
3R	17946291	0	0	0	0	0
3R	17947397	39	0	0	0	39
3R	17949372	0	0	0	0	0
3R	17967291	0	0	66	0	66
3R	17967728	30	0	31	0	61
3R	17976866	0	0	0	0	0
3R	17980448	0	0	4	0	4
3R	17986938	2	0	0	0	2
3R	17992257	0	0	0	0	0
3R	17994037	1	0	0	0	1
3R	17994206	0	0	1	0	1
3R	18017356	43	0	0	0	43
3R	18133238	15	0	0	0	15
3R	18199189	0	0	1	12	13
3R	18205263	2	0	0	0	2
3R	18226004	0	0	0	25	25
3R	18236442	24	0	0	0	24
3R	18238159	71	0	0	0	71
3R	18290939	0	2	0	54	56
3R	18355194	0	30	0	14	44
3R	18355198	0	29	0	14	43
3R	18355305	0	24	0	18	42
3R	18360355	0	0	0	6	6
3R	18498021	0	0	0	0	0
3R	18599594	0	0	0	0	0
3R	18674009	7	0	0	0	7
3R	18801700	0	3	0	26	29
3R	18806029	0	7	0	19	26
3R	18824181	0	0	0	0	0
3R	18881308	0	0	0	0	0
3R	18907574	525	0	54	0	579
3R	18907652	179	0	398	1	578
3R	18907675	172	0	372	0	544
3R	18907799	246	0	127	0	373
3R	18907980	372	2	134	0	508
3R	18910005	210	0	17	1	228
3R	18910153	36	0	214	0	250
3R	18970679	310	0	24	0	334
3R	18970692	265	0	53	0	318
3R	18971312	122	0	183	0	305
3R	19081553	0	1	0	0	1
3R	19140149	1	15	0	70	86
3R	19141001	0	14	0	103	117
3R	19218093	0	0	0	3	3
3R	19231096	0	35	0	302	337
3R	19231097	0	96	0	243	339
3R	19231100	0	21	0	310	331
3R	19238197	0	81	0	153	234
3R	19238358	0	74	0	166	240
3R	19238845	0	24	0	153	177
3R	19389278	0	0	0	1	1
3R	19579291	0	0	1	0	1
3R	19637450	0	0	0	59	59
3R	19643921	0	24	0	0	24
3R	19653645	0	92	0	0	92
3R	19660641	0	0	0	0	0
3R	19662383	0	0	28	0	28
3R	19662407	0	0	29	0	29
3R	19734535	0	0	0	0	0
3R	19753763	21	0	62	0	83
3R	19753764	7	0	77	0	84
3R	19763634	16	0	116	0	132
3R	19765660	64	0	27	2	93
3R	19766576	0	0	78	0	78
3R	19836444	0	0	0	2	2
3R	19840656	0	0	0	0	0
3R	19847652	29	0	0	0	29
3R	19848089	17	0	0	0	17
3R	19848545	19	0	1	0	20
3R	19850222	144	0	0	0	144
3R	19901320	0	0	0	177	177
3R	19901682	0	0	0	181	181
3R	19914707	0	0	0	619	619
3R	19977151	0	0	0	0	0
3R	20037752	0	6	0	14	20
3R	20253305	14	0	0	0	14
3R	20253308	14	0	2	0	16
3R	20254800	0	0	0	0	0
3R	20322199	83	0	68	0	151
3R	20323426	92	0	0	0	92
3R	20397317	0	0	0	2	2
3R	20397347	0	0	0	2	2
3R	20397348	0	0	0	2	2
3R	20397350	0	0	0	2	2
3R	20397351	0	0	0	2	2
3R	20397356	0	0	0	2	2
3R	20397361	0	0	0	2	2
3R	20397362	0	0	0	2	2
3R	20397364	0	0	0	2	2
3R	20397502	0	0	0	3	3
3R	20397510	0	1	0	2	3
3R	20397511	0	0	0	3	3
3R	20397525	0	1	0	2	3
3R	20397526	0	1	0	2	3
3R	20397527	0	0	0	3	3
3R	20442288	0	0	0	1	1
3R	20538040	0	2	0	17	19
3R	20964328	1434	1	745	1	2181
3R	20965039	1227	0	785	0	2012
3R	20978916	81	0	11	0	92
3R	20986865	0	0	0	0	0
3R	20993738	95	0	194	0	289
3R	20993841	94	0	183	0	277
3R	20993853	149	0	125	0	274
3R	21010468	68	0	12	0	80
3R	21010472	68	0	15	0	83
3R	21018588	18	0	77	0	95
3R	21018593	80	0	8	0	88
3R	21018596	27	0	62	0	89
3R	21018660	44	0	45	1	90
3R	21018693	10	0	80	0	90
3R	21018789	94	0	6	0	100
3R	21020302	32	0	17	0	49
3R	21020304	41	0	9	0	50
3R	21020562	6	0	33	0	39
3R	21032796	0	0	0	2	2
3R	21034155	0	0	0	2	2
3R	21035203	0	0	0	2	2
3R	21035311	0	1	0	0	1
3R	21036317	0	0	0	1	1
3R	21210519	6	0	0	0	6
3R	21213783	79	0	15	0	94
3R	21216016	61	0	0	0	61
3R	21228047	8	0	27	0	35
3R	21228182	17	0	33	0	50
3R	21268995	0	0	0	223	223
3R	21275768	0	377	0	0	377
3R	21277235	0	4	0	7	11
3R	21297848	384	0	46	0	430
3R	21316786	0	0	0	3	3
3R	21337167	0	5	0	13	18
3R	21360556	0	0	0	0	0
3R	21580556	0	3	0	0	3
3R	21795674	0	0	0	0	0
3R	21866357	0	5	0	0	5
3R	21979019	0	0	0	2	2
3R	22782190	1	0	0	0	1
3R	22784953	31	0	0	0	31
3R	23061604	27	0	0	0	27
3R	23081390	0	1	0	654	655
3R	23092053	0	0	0	1	1
3R	23112549	0	0	0	582	582
3R	23124996	0	13	0	0	13
3R	23124998	0	0	0	13	13
3R	23125099	0	0	0	13	13
3R	23125127	0	0	0	12	12
3R	23125179	0	0	0	12	12
3R	23125191	0	11	0	1	12
3R	23180642	0	0	0	0	0
3R	23183620	1	0	23	0	24
3R	23188969	0	216	0	0	216
3R	23191853	0	156	0	0	156
3R	23200370	0	0	0	15	15
3R	23228940	0	0	0	152	152
3R	23229652	0	0	0	77	77
3R	23229765	0	0	0	132	132
3R	23245868	0	0	0	0	0
3R	23248865	0	0	0	56	56
3R	23252005	0	0	0	0	0
3R	23261644	0	3	0	4	7
3R	23348613	1	0	0	0	1
3R	23348619	1	0	0	0	1
3R	23348769	1	0	0	0	1
3R	23348836	1	0	0	0	1
3R	23349750	1	0	0	0	1
3R	23355233	0	0	0	3	3
3R	23379528	0	0	0	23	23
3R	23662171	0	0	0	0	0
3R	23662433	0	0	0	0	0
3R	23806927	0	0	0	33	33
3R	23807724	0	0	0	31	31
3R	23812871	0	0	0	78	78
3R	23847794	99	0	0	0	99
3R	23848537	49	0	57	0	106
3R	23889222	0	5	0	1	6
3R	23889403	0	2	0	1	3
3R	23903183	0	0	0	51	51
3R	23906410	0	0	0	1	1
3R	23913774	0	0	0	0	0
3R	23930726	0	0	0	148	148
3R	23936205	0	0	0	743	743
3R	23941852	0	0	0	5	5
3R	23954031	0	0	0	43	43
3R	23954205	0	0	0	40	40
3R	23954270	0	0	0	43	43
3R	23975656	5	0	0	0	5
3R	23976395	252	0	1	0	253
3R	23981667	43	0	32	0	75
3R	23982357	178	0	65	0	243
3R	23983504	433	1	32	0	466
3R	23999913	0	0	0	136	136
3R	24000236	0	0	0	165	165
3R	24000858	0	5	0	9	14
3R	24028532	0	0	0	0	0
3R	24028545	0	0	0	0	0
3R	24035862	0	0	0	91	91
3R	24038324	29	0	0	0	29
3R	24051777	227	0	0	0	227
3R	24059369	30	0	0	0	30
3R	24059405	28	0	0	0	28
3R	24063411	19	0	0	0	19
3R	24065016	0	0	0	25	25
3R	24079314	0	0	0	0	0
3R	24080205	0	0	0	0	0
3R	24080856	0	0	0	0	0
3R	24089901	0	0	0	0	0
3R	24094522	0	0	0	1	1
3R	24096044	0	0	0	0	0
3R	24103714	0	55	0	115	170
3R	24115231	0	244	0	0	244
3R	24136443	37	0	0	0	37
3R	24136633	36	0	0	0	36
3R	24136663	26	0	0	0	26
3R	24141432	31	0	0	0	31
3R	24157937	0	0	0	57	57
3R	24162927	0	0	0	27	27
3R	24214769	0	0	0	4	4
3R	24228774	0	9	0	0	9
3R	24235203	0	0	0	0	0
3R	24292106	39	0	0	0	39
3R	24308629	60	0	0	0	60
3R	24309492	82	0	0	0	82
3R	24311331	19	0	44	0	63
3R	24399715	17	0	0	0	17
3R	24401818	0	14	0	26	40
3R	24511651	0	20	0	83	103
3R	24511656	0	21	0	84	105
3R	24512020	0	7	0	11	18
3R	24512901	0	2	0	9	11
3R	24512911	0	3	0	13	16
3R	24600699	0	0	0	0	0
3R	24668815	20	0	0	0	20
3R	24674513	75	0	5	0	80
3R	24675475	13	0	0	0	13
3R	24675663	9	0	59	0	68
3R	24690643	8	0	0	0	8
3R	24691493	118	0	9	0	127
3R	24692577	1	0	2	0	3
3R	24697793	7	0	1	0	8
3R	24706551	14	0	124	0	138
3R	24707423	42	0	100	0	142
3R	24707696	109	0	30	0	139
3R	24707890	133	0	21	0	154
3R	24708326	59	0	12	0	71
3R	24708329	55	0	17	0	72
3R	24708330	41	0	25	0	66
3R	24708356	61	0	11	0	72
3R	24829203	0	0	0	82	82
3R	25026672	27	0	0	0	27
3R	25039627	228	0	0	0	228
3R	25134628	0	0	0	0	0
3R	25136056	59	0	0	0	59
3R	25268354	0	0	0	0	0
3R	25346655	0	1	0	542	543
3R	25516393	0	0	0	0	0
3R	25530500	0	0	0	0	0
3R	25607422	0	0	0	9	9
3R	25680862	94	0	0	0	94
3R	25871448	27	0	0	0	27
3R	25871506	27	0	0	0	27
3R	25871531	27	0	0	0	27
3R	25871712	39	0	0	0	39
3R	25871911	37	0	0	0	37
3R	25965631	249	0	23	1	273
3R	25965643	2	0	268	0	270
3R	26275388	19	0	2	0	21
3R	26344955	0	0	0	0	0
3R	26384361	0	0	0	0	0
3R	26533202	0	0	0	1	1
3R	26533203	0	0	0	1	1
3R	26533204	0	0	0	1	1
3R	26533205	0	0	0	1	1
3R	26544601	1	0	0	0	1
3R	26555239	0	0	93	0	93
3R	26572578	0	0	0	0	0
3R	26593045	10	0	0	0	10
3R	26601314	0	0	88	0	88
3R	26681389	0	0	0	49	49
3R	26698436	0	0	0	230	230
3R	26699744	1	404	0	1	406
3R	26703453	0	0	0	1	1
3R	26706990	0	0	0	0	0
3R	26707060	0	0	0	0	0
3R	26710227	0	0	0	1	1
3R	26710639	0	0	0	1	1
3R	26711278	0	0	0	0	0
3R	26711482	0	0	0	0	0
3R	26722743	0	0	0	50	50
3R	26799601	0	0	0	0	0
3R	26803090	0	0	0	0	0
3R	26839293	0	0	69	0	69
3R	26839692	0	0	56	0	56
3R	26854725	0	0	0	1	1
3R	26869981	0	0	0	1021	1021
3R	26870035	0	0	0	1066	1066
3R	26898498	0	0	1	0	1
3R	26922349	0	0	0	0	0
3R	26941648	61	0	0	0	61
3R	26942517	93	1	0	0	94
3R	26950965	0	0	0	384	384
3R	26964540	0	0	0	14	14
3R	26971309	35	0	0	0	35
3R	27006713	0	0	0	0	0
3R	27059393	0	0	0	0	0
3R	27065920	0	0	0	71	71
3R	27065932	0	0	0	67	67
3R	27101403	0	0	0	21	21
3R	27155499	327	0	0	0	327
3R	27159080	74	0	0	0	74
3R	27237462	0	0	0	77	77
3R	27255644	112	0	0	0	112
3R	27260195	0	0	0	52	52
3R	27275221	6	0	1	0	7
3R	27436670	0	0	0	40	40
3R	27581330	0	0	0	1	1
3R	27610850	0	0	0	0	0
3R	27643914	0	33	1	228	262
3R	27669340	87	0	47	0	134
3R	27673172	97	0	114	0	211
3R	27673289	37	0	185	0	222
3R	27674209	0	0	179	0	179
3R	27674284	0	0	182	0	182
3R	27674568	106	0	153	0	259
3R	27674719	200	0	69	0	269
3R	27674736	25	0	236	0	261
3R	27674878	60	0	192	0	252
3R	27674907	113	0	153	0	266
3R	27675074	248	0	87	0	335
3R	27676160	242	0	51	0	293
3R	27676232	106	0	102	0	208
3R	27923909	2	0	0	0	2
3R	27928133	0	0	0	7	7
3R	27949844	145	0	0	0	145
3R	27954914	0	2	0	0	2
3R	27955650	0	0	4	0	4
3R	27956797	9	0	0	0	9
3R	27957947	0	27	0	0	27
3R	27965771	13	0	0	0	13
3R	27965792	15	0	0	0	15
3R	27966580	0	0	13	0	13
3R	27987451	0	0	0	0	0
3R	28077291	0	0	0	0	0
3R	28211257	0	0	0	0	0
3R	28418412	89	0	0	0	89
3R	28598794	0	10	0	15	25
3R	28630348	0	0	0	1	1
3R	28740661	0	0	0	0	0
3R	28755588	0	0	0	0	0
3R	28755612	0	0	0	0	0
3R	28824334	10	0	0	0	10
3R	28825660	0	0	0	67	67
3R	28834732	0	0	0	71	71
3R	28841035	0	0	0	0	0
3R	28842883	0	2	0	0	2
3R	28845314	0	2	0	0	2
3R	28845906	0	0	32	0	32
3R	28874903	37	0	0	0	37
3R	28877734	0	0	0	15	15
3R	28883203	0	0	0	1	1
3R	28893176	0	0	31	0	31
3R	28903133	11	0	0	0	11
3R	28910138	41	0	0	0	41
3R	28925501	0	0	1	48	49
3R	29682986	5	0	2	0	7
3R	29725169	41	0	0	0	41
3R	29809019	0	0	12	0	12
3R	29852709	37	0	0	0	37
3R	29877130	97	0	0	0	97
3R	29877330	22	0	0	0	22
3R	29877364	16	0	0	0	16
3R	29990367	26	0	0	0	26
3R	29991674	0	0	0	25	25
3R	30002686	0	0	0	89	89
3R	30012340	0	0	0	6	6
3R	30012471	0	0	0	10	10
3R	30014618	0	0	0	7	7
3R	30036766	0	0	0	19	19
3R	30040555	30	0	0	0	30
3R	30083131	5	0	0	0	5
3R	30092365	10	0	0	0	10
3R	30103150	35	0	0	0	35
3R	30104256	201	0	0	0	201
3R	30112301	239	0	0	0	239
3R	30113784	81	0	0	0	81
3R	30114780	38	0	0	0	38
3R	30115158	26	0	0	0	26
3R	30199030	0	0	0	0	0
3R	30303048	0	0	0	0	0
3R	30420927	0	0	0	92	92
3R	30774448	0	0	19	0	19
3R	30796901	0	0	0	2	2
3R	31046504	29	0	0	0	29
3R	31160434	5	0	0	0	5
3R	31228686	56	0	40	0	96
3R	31597431	0	65	0	231	296
3R	31597432	0	99	0	191	290
3R	31599016	0	72	0	774	846
3R	31601718	0	182	0	423	605
3R	31601828	0	148	0	722	870
3R	31602191	0	173	1	966	1140
3R	31608331	0	2	0	21	23
3R	31724907	1	0	0	0	1
3R	31837086	38	0	21	0	59
3R	31837089	26	0	36	0	62
3R	31844215	55	0	14	0	69
3R	31844748	55	0	19	0	74
4	55144	0	1	0	0	1
4	76506	0	0	0	0	0
4	86500	0	0	0	0	0
4	100011	12	0	0	0	12
4	100035	5	0	4	0	9
4	100181	1	0	10	0	11
4	100197	7	0	3	0	10
4	100200	10	0	0	0	10
4	100204	8	0	2	0	10
4	100214	10	0	1	0	11
4	100219	7	0	0	0	7
4	100289	13	0	6	0	19
4	100442	35	0	0	0	35
4	100530	27	0	6	0	33
4	100539	29	0	5	0	34
4	100543	18	0	15	0	33
4	100547	31	0	1	0	32
4	100549	19	0	14	0	33
4	100554	18	0	10	0	28
4	100556	30	0	0	0	30
4	100557	17	0	11	0	28
4	100558	27	0	2	0	29
4	100559	23	0	6	0	29
4	100560	7	0	21	0	28
4	100563	4	0	22	0	26
4	100629	10	0	5	0	15
4	101660	9	0	35	0	44
4	102327	20	0	13	0	33
4	102349	15	0	10	0	25
4	113007	58	0	30	0	88
4	126831	0	0	0	0	0
4	126842	0	0	0	0	0
4	128747	0	0	0	2	2
4	182444	0	1	0	6	7
4	182525	0	0	0	8	8
4	191689	0	11	0	16	27
4	191704	0	14	0	16	30
4	191708	0	11	0	22	33
4	192653	1	4	0	16	21
4	192661	0	17	0	6	23
4	192670	0	11	0	13	24
4	192672	0	1	0	25	26
4	192677	0	17	0	8	25
4	192684	0	12	0	16	28
4	192692	0	11	0	18	29
4	192715	0	13	0	22	35
4	192723	0	7	0	26	33
4	192724	0	8	0	25	33
4	213353	15	0	28	0	43
4	213371	22	0	19	0	41
4	214241	23	0	2	0	25
4	234621	0	0	2	0	2
4	234717	4	0	0	0	4
4	234747	0	0	4	0	4
4	234775	2	0	1	0	3
4	234798	4	0	0	0	4
4	235270	2	0	2	0	4
4	235273	3	0	1	0	4
4	235277	4	0	0	0	4
4	235278	4	0	0	0	4
4	235280	3	0	0	0	3
4	235284	2	0	1	0	3
4	235287	1	0	2	0	3
4	235308	3	0	0	0	3
4	235309	3	0	0	0	3
4	235310	3	0	0	0	3
4	235311	1	0	2	0	3
4	235313	1	0	2	0	3
4	235317	2	0	1	0	3
4	235319	3	0	0	0	3
4	235336	3	0	0	0	3
4	235338	3	0	0	0	3
4	235343	3	0	0	0	3
4	235344	3	0	0	0	3
4	235495	4	0	0	0	4
4	235496	3	0	1	0	4
4	235506	5	0	0	0	5
4	265270	19	0	0	0	19
4	265273	19	0	0	0	19
4	292019	0	2	0	0	2
4	292441	0	0	0	1	1
4	294654	0	0	0	0	0
4	295725	0	0	0	3	3
4	304161	0	0	0	0	0
4	328580	0	7	0	10	17
4	339075	0	2	0	14	16
4	340376	0	5	0	4	9
4	340381	0	3	0	7	10
4	340398	0	5	0	6	11
4	341198	0	0	0	22	22
4	341200	0	0	0	23	23
4	343860	0	0	0	2	2
4	351351	0	0	0	7	7
4	351417	0	0	0	5	5
4	356697	0	1	0	0	1
4	356702	0	0	0	1	1
4	356711	0	1	0	0	1
4	356722	0	1	0	0	1
4	356723	0	0	0	0	0
4	356726	0	0	0	1	1
4	356734	0	0	0	1	1
4	356773	0	0	0	1	1
4	357621	0	0	0	1	1
4	357626	0	0	0	1	1
4	357672	0	0	0	1	1
4	357673	0	0	0	1	1
4	367899	7	0	0	0	7
4	403085	0	0	2	0	2
4	446514	93	0	31	0	124
4	446530	107	0	15	1	123
4	448154	26	0	9	0	35
4	448773	31	0	10	0	41
4	449601	75	0	4	0	79
4	449602	60	0	13	0	73
4	449672	55	0	10	0	65
4	449705	56	0	9	0	65
4	449711	60	0	8	0	68
4	449740	58	0	14	0	72
4	449751	52	0	18	0	70
4	449767	58	0	7	0	65
4	454069	82	0	2	0	84
4	454073	79	0	1	0	80
4	454076	66	0	11	0	77
4	454085	70	0	13	0	83
4	455119	8	0	8	0	16
4	455123	11	0	5	0	16
4	455582	14	0	5	0	19
4	455778	18	0	1	0	19
4	459603	15	0	1	0	16
4	459637	13	0	1	0	14
4	476665	0	3	0	8	11
4	476688	0	7	0	4	11
4	476701	0	3	0	4	7
4	476921	0	10	0	3	13
4	520535	0	0	0	0	0
4	541492	0	12	0	11	23
4	541536	0	15	0	9	24
4	541538	0	9	0	16	25
4	541539	0	22	0	5	27
4	541545	0	7	0	20	27
4	541585	0	11	0	14	25
4	541776	0	6	0	25	31
4	541778	0	16	0	14	30
4	541780	0	1	0	28	29
4	541782	0	17	0	13	30
4	541784	0	15	0	13	28
4	541793	30	0	0	0	30
4	541795	0	2	0	30	32
4	541819	0	1	0	34	35
4	541822	0	3	0	32	35
4	541825	0	0	0	35	35
4	541826	0	1	0	34	35
4	541828	0	0	0	33	33
4	541882	0	0	0	36	36
4	541884	0	0	0	35	35
4	541886	0	2	0	33	35
4	541887	0	1	0	33	34
4	541889	0	1	0	33	34
4	541890	0	2	0	32	34
4	560912	36	0	3	0	39
4	560934	32	0	8	0	40
4	561097	28	0	11	0	39
4	563220	10	0	0	0	10
4	563252	6	0	0	0	6
4	563258	5	0	0	0	5
4	563274	5	0	0	0	5
4	563284	5	0	0	0	5
4	563291	0	0	0	0	0
4	563330	0	0	0	0	0
4	563333	0	0	0	0	0
4	563340	0	0	0	0	0
4	563347	0	0	0	0	0
4	563352	0	0	0	0	0
4	563354	0	0	0	0	0
4	563367	0	0	0	0	0
4	563368	0	0	0	0	0
4	563369	0	0	0	0	0
4	563370	0	0	0	0	0
4	563373	0	0	0	0	0
4	563377	0	0	0	0	0
4	563380	0	0	0	0	0
4	563383	0	0	0	0	0
4	563384	0	0	0	0	0
4	563385	0	0	0	0	0
4	563386	0	0	0	0	0
4	563390	0	0	0	0	0
4	563396	0	0	0	0	0
4	563398	0	0	0	0	0
4	563399	0	0	0	0	0
4	563401	0	0	0	0	0
4	563402	0	0	0	0	0
4	563403	0	0	0	0	0
4	563405	0	0	0	0	0
4	563409	0	0	0	0	0
4	563414	0	0	0	0	0
4	563416	0	0	0	0	0
4	563537	0	0	0	0	0
4	579932	8	0	0	0	8
4	579972	10	0	0	0	10
4	579974	10	0	0	0	10
4	579978	9	0	0	0	9
4	579980	10	0	0	0	10
4	602510	0	9	0	10	19
4	612525	12	0	0	0	12
4	636945	0	4	0	1	5
4	638429	0	0	0	5	5
4	653771	0	0	0	0	0
4	654895	0	6	0	17	23
4	654898	0	5	0	16	21
4	659412	0	1	0	38	39
4	667083	27	0	0	0	27
4	667084	24	0	5	0	29
4	667085	24	0	5	0	29
4	667101	12	0	10	0	22
4	667104	16	0	7	0	23
4	668200	15	0	5	0	20
4	668202	11	0	9	0	20
4	686912	33	0	11	0	44
4	686921	35	0	10	0	45
4	686924	27	0	18	0	45
4	686926	40	0	3	0	43
4	686929	22	0	21	0	43
4	686932	24	0	20	0	44
4	686941	39	0	5	0	44
4	686958	31	0	5	0	36
4	686973	33	0	4	0	37
4	686981	43	0	0	0	43
4	687294	19	0	12	0	31
4	688162	51	0	8	0	59
4	725144	0	0	0	0	0
4	743070	28	0	2	0	30
4	744196	0	0	0	0	0
4	744197	0	0	0	0	0
4	744213	0	0	0	0	0
4	744215	0	0	0	0	0
4	744797	2	0	0	0	2
4	744886	2	0	0	0	2
4	744897	2	0	0	0	2
4	745047	3	0	0	0	3
4	745107	3	0	0	0	3
4	747687	39	0	1	0	40
4	747738	27	0	14	0	41
4	767187	131	0	3	0	134
4	767264	106	0	7	0	113
4	823281	0	0	0	0	0
4	856273	0	4	0	12	16
4	856282	0	3	0	11	14
4	856311	0	6	0	10	16
4	856324	0	0	0	15	15
4	856326	0	6	0	9	15
4	856328	0	3	0	12	15
4	856331	0	3	0	12	15
4	856359	0	6	0	7	13
4	856373	0	1	0	11	12
4	857770	0	12	0	7	19
4	858835	0	5	0	7	12
4	858841	0	1	0	11	12
4	860159	0	7	0	5	12
4	860173	0	4	0	6	10
4	860227	0	7	0	3	10
4	860232	0	4	0	6	10
4	860236	0	3	0	6	9
4	874383	1	193	0	114	308
4	878970	0	98	0	250	348
4	879448	0	7	0	47	54
4	879496	0	27	0	12	39
4	879936	0	6	0	60	66
4	882370	0	31	0	48	79
4	889066	0	22	0	23	45
4	895648	0	0	0	1	1
4	896129	0	0	0	1	1
4	896139	0	0	0	1	1
4	896192	0	0	0	0	0
4	897223	0	1	0	1	2
4	897246	0	0	0	1	1
4	897262	0	0	0	1	1
4	897309	0	0	0	1	1
4	908982	0	6	0	4	10
4	980493	0	0	3	0	3
4	980622	3	0	0	0	3
4	999228	9	0	3	0	12
4	1039524	0	7	0	58	65
4	1039649	0	3	0	57	60
4	1040392	0	9	0	72	81
4	1040397	0	16	0	68	84
4	1041214	0	63	0	64	127
4	1041225	0	66	0	77	143
4	1041307	0	91	0	49	140
4	1041381	0	24	0	125	149
4	1041388	0	32	0	107	139
4	1041389	0	13	0	131	144
4	1041395	0	26	1	105	132
4	1041418	0	18	0	118	136
4	1041449	0	22	0	132	154
4	1041451	0	78	0	78	156
4	1041452	0	33	0	122	155
4	1041464	0	3	0	147	150
4	1041465	0	18	0	135	153
4	1041478	0	40	0	97	137
4	1041482	0	27	0	115	142
4	1041483	0	10	0	130	140
4	1041494	0	68	0	66	134
4	1041500	0	13	0	118	131
4	1041514	0	25	0	115	140
4	1041521	0	19	0	121	140
4	1041544	0	40	0	102	142
4	1042206	0	36	0	96	132
4	1042231	0	18	0	118	136
4	1042257	0	34	0	97	131
4	1042367	0	14	0	158	172
4	1042368	0	22	0	148	170
4	1042371	0	79	0	84	163
4	1042502	0	60	0	90	150
4	1042610	0	58	0	97	155
4	1042667	0	28	0	146	174
4	1042794	0	8	0	154	162
4	1042907	0	15	0	102	117
4	1042971	0	9	0	95	104
4	1042975	0	16	0	95	111
4	1045395	0	0	0	1	1
4	1045396	0	0	0	1	1
4	1046984	0	0	0	2	2
4	1046986	0	0	0	3	3
4	1046987	0	0	0	3	3
4	1051636	0	6	0	3	9
4	1052332	0	0	0	2	2
4	1125511	1	0	2	0	3
4	1125515	3	0	0	0	3
4	1125529	1	0	1	0	2
4	1125587	1	0	1	0	2
4	1125632	1	0	1	0	2
4	1126049	2	0	0	0	2
4	1126064	2	0	0	0	2
4	1126065	2	0	0	0	2
4	1126078	1	0	0	0	1
4	1126349	3	0	1	0	4
4	1132912	17	0	7	0	24
4	1132913	18	0	1	0	19
4	1132915	9	0	13	0	22
4	1132917	21	0	3	0	24
4	1132932	23	0	3	0	26
4	1132946	12	0	14	0	26
4	1133654	3	0	45	0	48
4	1133655	21	0	27	0	48
4	1134443	134	0	46	0	180
4	1134452	145	0	15	0	160
4	1134469	114	0	53	0	167
4	1134830	94	0	11	0	105
4	1134861	23	0	68	0	91
4	1134869	71	0	16	0	87
4	1136039	22	0	4	0	26
4	1136068	24	0	3	0	27
4	1137308	4	0	25	0	29
4	1148236	2	0	0	0	2
4	1148466	0	0	4	0	4
4	1168877	6	0	3	0	9
4	1232612	5	0	1	0	6
4	1232942	6	0	1	0	7
4	1234422	6	0	4	0	10
4	1234429	6	0	4	0	10
4	1244706	3	0	11	0	14
4	1244726	8	0	5	0	13
4	1244727	6	0	6	0	12
4	1252829	12	0	28	0	40
4	1252993	31	0	9	0	40
4	1254576	27	0	5	0	32
4	1255125	20	0	1	0	21
4	1255131	13	0	8	0	21
4	1255132	19	0	1	0	20
4	1255154	16	0	5	0	21
4	1255163	21	0	1	0	22
4	1255168	19	0	5	0	24
4	1257070	17	0	9	1	27
4	1257336	14	0	0	0	14
4	1257543	6	0	3	0	9
4	1257984	37	0	4	0	41
4	1260280	2	0	6	0	8
4	1260284	4	0	6	0	10
4	1265107	153	0	177	0	330
4	1267648	4	0	0	0	4
Un_DS483999v1	2471	0	0	0	0	0
Un_DS484083v1	1024	0	0	0	0	0
Un_DS484090v1	1859	0	0	0	0	0
Un_DS484176v1	2586	0	0	0	0	0
Un_DS484511v1	1204	0	0	0	0	0
Un_DS484539v1	1135	0	0	0	0	0
Un_DS484746v1	578	0	0	0	0	0
Un_DS485536v1	813	0	0	0	0	0
Un_DS485605v1	551	0	0	0	0	0
X	514252	0	26	0	37	63
X	514297	0	12	0	46	58
X	514298	0	13	0	44	57
X	516944	0	9	0	25	34
X	516949	0	7	0	28	35
X	516964	0	12	0	24	36
X	923306	0	0	0	77	77
X	923307	0	0	0	79	79
X	924277	0	65	0	52	117
X	1373346	198	0	84	0	282
X	1373528	110	0	90	0	200
X	1373589	129	0	47	0	176
X	1373602	151	0	35	0	186
X	1378095	194	0	45	0	239
X	1378279	147	0	77	0	224
X	1378284	129	0	101	0	230
X	1491577	0	25	0	29	54
X	1676057	0	98	0	11	109
X	1676066	0	35	0	83	118
X	1676597	0	149	0	30	179
X	1690573	0	68	0	87	155
X	1781840	63	0	54	0	117
X	1784005	45	0	51	0	96
X	1784034	49	0	35	0	84
X	1784035	69	0	19	0	88
X	1784036	50	0	36	0	86
X	1785204	128	0	5	0	133
X	1785212	123	0	11	0	134
X	1785216	101	0	38	0	139
X	1785256	111	0	1	0	112
X	1785441	85	0	3	0	88
X	1785444	89	0	2	0	91
X	1785543	85	0	6	0	91
X	1785888	27	0	54	0	81
X	1785903	59	0	15	0	74
X	1786528	103	0	3	0	106
X	1854163	0	0	0	1	1
X	1854164	0	0	0	1	1
X	2078771	0	0	0	54	54
X	2112342	135	0	38	0	173
X	2112355	141	0	27	0	168
X	2112356	126	0	48	0	174
X	2180389	0	0	0	0	0
X	2219688	0	5	0	7	12
X	2376647	0	21	0	16	37
X	2434676	0	1	0	2	3
X	2515228	0	0	0	3	3
X	2625116	2	0	0	0	2
X	2628866	53	0	137	0	190
X	2660761	147	0	0	0	147
X	2667642	0	0	0	0	0
X	2677613	132	0	4	0	136
X	2678338	90	0	7	0	97
X	2678342	75	0	28	0	103
X	3297989	4	0	1	0	5
X	3342781	4	0	0	0	4
X	3343393	22	1	0	0	23
X	3477696	0	0	0	53	53
X	3719089	0	0	0	1	1
X	3730329	0	0	0	0	0
X	3859628	0	343	0	1927	2270
X	3859645	1	495	0	1678	2174
X	3860640	0	252	1	1935	2188
X	3860692	0	281	0	2035	2316
X	3860693	1	1005	0	1289	2295
X	3860694	0	208	0	2117	2325
X	3861312	5	169	0	1486	1660
X	3861498	0	396	0	1504	1900
X	3861499	0	418	4	1412	1834
X	3861500	0	207	0	1687	1894
X	3861501	3	1523	0	293	1819
X	3861505	0	1275	0	538	1813
X	3895378	0	0	0	42	42
X	3953264	166	0	67	0	233
X	4102802	0	0	0	0	0
X	4217290	0	0	0	0	0
X	4352383	3	0	2	0	5
X	4356397	55	0	1	0	56
X	4689184	1	0	0	0	1
X	4689563	0	0	0	0	0
X	4701126	0	0	0	204	204
X	4711852	0	0	1	0	1
X	4981377	0	0	0	0	0
X	5087477	3	0	3	0	6
X	5170349	10	0	4	0	14
X	5239523	38	0	12	0	50
X	5251934	0	0	0	64	64
X	5252342	27	0	12	0	39
X	5360710	1	0	1	0	2
X	5396519	20	0	11	0	31
X	5397332	0	0	8	0	8
X	5397347	6	0	6	0	12
X	5397612	10	0	2	0	12
X	5630114	0	337	0	58	395
X	5630195	0	54	0	374	428
X	5630213	0	221	0	219	440
X	5630234	0	332	0	82	414
X	5630342	1	188	0	190	379
X	5630737	0	30	5	307	342
X	5631026	0	115	0	133	248
X	5631035	1	209	0	35	245
X	5631048	0	218	0	43	261
X	5788690	0	0	22	0	22
X	5810061	0	0	0	0	0
X	5963943	0	1	0	0	1
X	5998043	0	1	0	24	25
X	6105139	0	4	0	113	117
X	6107611	0	94	0	250	344
X	6107620	0	177	0	162	339
X	6107716	0	81	0	36	117
X	6108552	0	204	0	60	264
X	6108553	0	247	0	17	264
X	6108712	0	170	0	10	180
X	6108766	0	78	0	134	212
X	6109871	0	38	0	192	230
X	6112645	0	13	0	147	160
X	6115425	0	156	0	20	176
X	6145386	0	25	0	118	143
X	6184321	0	0	0	0	0
X	6531547	0	1	0	0	1
X	6537186	0	0	7	0	7
X	6577785	3	0	1	0	4
X	6790259	0	1	0	3	4
X	7085816	0	79	0	33	112
X	7445827	15	0	7	0	22
X	7698223	0	0	0	0	0
X	7912801	70	1	0	0	71
X	7938121	0	0	0	0	0
X	7987553	0	0	0	0	0
X	8046474	0	0	0	5	5
X	8055921	0	0	0	0	0
X	8055924	0	0	0	0	0
X	8240090	52	0	79	0	131
X	8240161	103	0	24	1	128
X	8247628	240	0	161	0	401
X	8272518	0	5	0	3	8
X	8403319	5	0	20	0	25
X	8409426	0	1	0	25	26
X	8518112	10	0	0	0	10
X	8632440	0	19	0	21	40
X	8649283	0	1	0	1	2
X	8908884	0	2	0	6	8
X	8910271	0	6	0	1	7
X	8917312	1	0	0	0	1
X	8927652	2	0	1	0	3
X	8927665	2	0	0	0	2
X	8941468	0	0	0	0	0
X	8942088	5	0	0	0	5
X	8942812	2	0	0	0	2
X	8966417	6	0	0	0	6
X	9002119	0	0	0	1	1
X	9020223	13	0	29	0	42
X	9020239	21	0	22	0	43
X	9020384	2	0	25	0	27
X	9022297	0	0	0	89	89
X	9022830	64	0	5	0	69
X	9022835	16	0	53	0	69
X	9022869	12	0	44	0	56
X	9022902	46	0	6	0	52
X	9022931	38	0	35	0	73
X	9022942	41	0	27	0	68
X	9022943	62	0	7	0	69
X	9028080	79	0	63	0	142
X	9028091	80	0	66	0	146
X	9037319	0	0	0	0	0
X	9153487	0	193	0	1613	1806
X	9200948	0	0	0	1	1
X	9278576	0	10	0	27	37
X	9340169	0	0	0	0	0
X	9574655	0	53	0	20	73
X	9754490	3	0	15	0	18
X	10016995	0	0	0	0	0
X	10247964	0	3	0	11	14
X	10330625	0	0	0	0	0
X	10356486	184	0	0	0	184
X	10463690	49	0	0	0	49
X	10639732	0	0	0	0	0
X	10709480	60	0	14	0	74
X	10711327	0	0	0	24	24
X	10711351	0	0	0	26	26
X	10746485	110	0	40	0	150
X	10746488	103	0	51	0	154
X	10817179	0	0	0	0	0
X	10835849	0	64	0	25	89
X	10846781	0	52	0	60	112
X	11047667	7	0	2	0	9
X	11047679	6	0	5	0	11
X	11047750	5	0	8	0	13
X	11047753	7	0	7	0	14
X	11048103	2	0	7	0	9
X	11052798	0	236	0	213	449
X	11221249	0	0	0	20	20
X	11221253	0	1	0	19	20
X	11221255	0	0	0	20	20
X	11221259	0	1	0	18	19
X	11221261	0	0	0	20	20
X	11221263	0	1	0	19	20
X	11221265	0	0	0	18	18
X	11221267	0	1	0	19	20
X	11221296	0	0	0	25	25
X	11221308	0	1	0	21	22
X	11221310	0	0	0	23	23
X	11221312	0	0	0	23	23
X	11221318	0	3	0	20	23
X	11221322	0	1	0	21	22
X	11221325	0	1	0	20	21
X	11224387	0	22	0	16	38
X	11330935	84	0	0	0	84
X	11371626	0	0	0	0	0
X	11553315	74	0	0	0	74
X	11575555	8	0	13	0	21
X	11704179	152	0	35	0	187
X	11704188	114	0	64	0	178
X	11812074	0	60	0	76	136
X	11812089	0	71	0	72	143
X	11939698	0	23	0	44	67
X	11939764	0	10	0	46	56
X	11949882	0	28	0	19	47
X	11949883	0	12	0	37	49
X	11954277	0	35	0	11	46
X	11955525	0	2	0	6	8
X	11955561	0	7	0	1	8
X	11964192	0	10	0	48	58
X	11967712	0	9	0	14	23
X	11968032	0	15	0	11	26
X	11968676	0	2	0	55	57
X	11968768	0	33	0	18	51
X	11968969	0	14	0	28	42
X	11970546	1	6	0	32	39
X	11970552	0	1	0	30	31
X	11970556	0	13	0	25	38
X	11971853	0	26	0	11	37
X	11977538	0	30	0	14	44
X	12178407	0	0	0	0	0
X	12234654	1	0	0	0	1
X	12321994	0	0	92	0	92
X	12411368	0	0	0	0	0
X	12446818	32	0	2	0	34
X	12517682	0	13	0	21	34
X	12517716	0	4	0	33	37
X	12530707	0	0	0	0	0
X	12570094	0	3	0	11	14
X	12570147	0	11	0	5	16
X	12610058	0	1	0	67	68
X	12633103	2	0	3	0	5
X	12638680	294	0	44	0	338
X	12670776	1	0	0	0	1
X	12772709	14	0	29	0	43
X	12779207	0	5	0	5	10
X	12836423	0	0	0	0	0
X	12920895	9	0	0	0	9
X	13075382	26	0	63	0	89
X	13326657	0	0	46	0	46
X	13338794	38	0	0	0	38
X	13363027	0	0	1	0	1
X	13363147	0	0	3	0	3
X	13364994	16	0	21	0	37
X	13375332	0	0	3	0	3
X	13713539	29	0	4	0	33
X	13713540	25	0	4	0	29
X	13713557	31	0	2	0	33
X	13713560	27	0	1	0	28
X	13713989	16	0	5	0	21
X	13714028	25	0	2	0	27
X	13714030	19	0	7	0	26
X	13714099	25	0	0	0	25
X	13714108	20	0	4	0	24
X	13915030	0	0	0	0	0
X	13960364	0	0	0	0	0
X	13981405	0	0	0	2	2
X	13988603	0	0	0	1	1
X	14017285	0	0	0	0	0
X	14272086	73	0	30	0	103
X	14272092	3	0	92	0	95
X	14272096	3	0	97	0	100
X	14274268	74	0	26	0	100
X	14791453	0	35	1	91	127
X	14803625	0	0	0	1	1
X	14827027	0	12	0	47	59
X	14827028	0	15	0	44	59
X	14827029	0	20	0	41	61
X	14904567	1263	0	0	0	1263
X	14932507	44	0	20	0	64
X	14996674	18	0	23	0	41
X	14999166	0	0	3	0	3
X	14999641	5	0	3	0	8
X	14999868	4	0	39	0	43
X	14999920	50	0	8	0	58
X	14999924	6	0	53	0	59
X	14999938	43	0	8	0	51
X	15000623	17	0	35	0	52
X	15002265	9	0	17	0	26
X	15004413	19	0	34	0	53
X	15004776	12	0	30	0	42
X	15004857	23	0	40	0	63
X	15004878	49	0	17	0	66
X	15043300	0	0	0	0	0
X	15058391	0	30	0	20	50
X	15098493	76	0	58	0	134
X	15098592	69	0	76	1	146
X	15111879	41	0	84	0	125
X	15112038	39	0	2	0	41
X	15304670	0	0	0	0	0
X	15388627	0	16	0	32	48
X	15392685	0	92	0	15	107
X	15483634	38	0	0	0	38
X	15484167	25	0	1	0	26
X	15501741	0	0	0	0	0
X	15531613	0	0	0	1	1
X	15581889	0	19	0	0	19
X	15897294	387	0	299	0	686
X	15897759	17	0	19	0	36
X	15897789	36	0	2	0	38
X	15897854	28	0	14	0	42
X	15897856	38	0	1	0	39
X	15903965	12	0	136	0	148
X	15919889	126	0	9	0	135
X	15952334	0	2	0	7	9
X	15956689	0	6	0	14	20
X	15956841	0	1	0	20	21
X	15958587	0	96	0	6	102
X	15961105	0	0	0	5	5
X	15961636	0	1	0	13	14
X	15989371	0	0	0	46	46
X	16075853	0	0	0	40	40
X	16339624	53	0	52	0	105
X	16339799	62	0	7	0	69
X	16456420	0	0	0	14	14
X	16456425	0	4	0	10	14
X	16460238	0	5	0	34	39
X	16460589	0	4	0	40	44
X	16460590	0	2	0	42	44
X	16460595	0	7	0	37	44
X	16464719	0	41	0	5	46
X	16466198	0	6	0	11	17
X	16466199	0	15	0	2	17
X	16466203	0	4	0	10	14
X	16466204	0	2	0	11	13
X	16466216	0	0	0	14	14
X	16466692	0	0	0	51	51
X	16468562	0	36	0	4	40
X	16469630	0	7	0	23	30
X	16469631	0	13	0	17	30
X	16471229	0	15	0	24	39
X	16471265	0	19	0	28	47
X	16471290	0	6	0	45	51
X	16471319	0	17	0	28	45
X	16471811	0	8	0	9	17
X	16471812	0	9	0	10	19
X	16471813	0	10	0	7	17
X	16471814	0	6	0	12	18
X	16473609	0	3	0	24	27
X	16473610	0	2	0	24	26
X	16473637	0	8	0	14	22
X	16473638	0	3	0	19	22
X	16475638	0	8	0	42	50
X	16475685	0	1	0	42	43
X	16477558	0	5	0	19	24
X	16481881	0	4	0	14	18
X	16482682	0	18	0	18	36
X	16482683	0	7	0	29	36
X	16482692	0	2	0	33	35
X	16482693	0	20	0	16	36
X	16504240	0	31	0	20	51
X	16504273	0	0	0	61	61
X	16505310	0	1	0	20	21
X	16505550	0	52	0	12	64
X	16509658	0	7	0	42	49
X	16509671	0	4	0	50	54
X	16509684	0	11	0	41	52
X	16511854	0	3	0	13	16
X	16514487	0	1	0	7	8
X	16517164	0	14	0	7	21
X	16518833	0	39	0	13	52
X	16523520	0	0	0	0	0
X	16523529	0	0	0	0	0
X	16523541	0	0	0	0	0
X	16523553	0	0	0	0	0
X	16523556	0	0	0	0	0
X	16523557	0	0	0	0	0
X	16532860	0	0	0	3	3
X	16532866	0	0	0	3	3
X	16562027	0	18	0	59	77
X	16562108	0	19	0	58	77
X	16681534	0	3	0	31	34
X	16839820	0	13	0	45	58
X	16839947	0	1	0	52	53
X	16905030	0	0	0	2	2
X	16915290	4	0	0	0	4
X	17016883	0	1	0	0	1
X	17016898	0	0	0	1	1
X	17017015	0	1	0	2	3
X	17027613	0	0	0	0	0
X	17082644	0	0	0	0	0
X	17097065	50	0	0	0	50
X	17291667	0	0	0	1	1
X	17666685	532	0	0	0	532
X	17674476	0	2	0	2	4
X	17926624	0	21	0	9	30
X	17930651	0	39	0	15	54
X	17930658	0	50	0	4	54
X	17930733	0	33	0	20	53
X	17930890	0	22	0	3	25
X	17930948	0	11	0	11	22
X	17936502	0	1	0	23	24
X	17938011	0	0	0	96	96
X	17941537	0	3	0	19	22
X	17941569	0	0	0	15	15
X	17941570	0	1	0	15	16
X	17942236	0	0	0	11	11
X	17945833	0	1	0	16	17
X	17950057	0	19	0	104	123
X	17952716	0	7	0	98	105
X	17952717	0	6	0	101	107
X	17961411	0	0	0	0	0
X	17981650	0	6	0	12	18
X	17982144	0	13	0	0	13
X	17983811	0	15	0	15	30
X	17983847	0	23	0	5	28
X	17987714	0	0	0	10	10
X	17987788	0	1	0	12	13
X	17987790	0	9	0	4	13
X	17987796	0	8	0	6	14
X	17988376	0	0	0	5	5
X	17989432	0	0	0	13	13
X	17989433	0	13	0	1	14
X	17991679	0	0	0	0	0
X	17991684	0	0	0	0	0
X	17991689	0	0	0	0	0
X	17991690	0	0	0	0	0
X	17991691	0	0	0	0	0
X	18107572	0	0	0	18	18
X	18107970	0	2	0	11	13
X	18170126	8	0	34	0	42
X	18172085	64	0	0	0	64
X	18172108	51	0	0	0	51
X	18173979	28	0	3	0	31
X	18174020	20	0	4	0	24
X	18174056	19	0	3	0	22
X	18177807	7	0	0	0	7
X	18201429	73	0	12	0	85
X	18558815	3	0	2	0	5
X	18901523	2	0	0	0	2
X	19153046	0	0	0	77	77
X	19265115	8	0	17	0	25
X	19265410	0	0	2	0	2
X	19283881	0	34	0	55	89
X	19334465	0	39	0	7	46
X	19334522	0	9	0	32	41
X	19341081	0	1	0	20	21
X	19341084	0	2	0	20	22
X	19341882	0	2	0	68	70
X	19342007	0	41	0	38	79
X	19508447	334	0	51	0	385
X	19545747	0	0	0	7	7
X	19641588	0	41	0	62	103
X	19651650	0	0	0	17	17
X	19727697	13	0	134	0	147
X	19727698	15	0	131	0	146
X	19831888	0	3	0	22	25
X	19835017	0	13	0	27	40
X	19857622	13	0	0	0	13
X	19888186	2	0	0	0	2
X	20330037	0	0	0	0	0
X	20330041	0	0	0	0	0
X	20770084	0	4	0	5	9
X	20773442	0	6	0	4	10
X	20819626	0	0	0	0	0
X	20828303	0	1	0	1	2
X	20828316	0	0	0	2	2
X	20828348	0	1	0	1	2
X	20828364	0	3	0	0	3
X	20828369	0	3	0	0	3
X	20828370	0	2	0	1	3
X	20923843	0	5	0	11	16
X	20924823	0	0	0	3	3
X	21068672	0	0	0	0	0
X	21304740	0	0	0	0	0
X	21629428	0	123	0	203	326
X	21629453	0	123	0	208	331
X	21629508	0	30	0	274	304
X	21629725	0	164	0	139	303
X	21629726	0	122	0	176	298
X	21629727	0	117	0	186	303
X	21629737	0	161	0	141	302
X	22489005	4	0	3	0	7
X	22489022	6	0	0	0	6
X	22499716	51	0	12	0	63
X	22499717	33	0	31	0	64
X	22499732	15	0	49	0	64
X	22502642	221	0	34	0	255
X	22502713	59	0	179	0	238
X	22502735	184	0	51	0	235
X	22980987	1	11	0	210	222
X	22982709	0	430	0	226	656
X	22983936	0	12	0	9	21
X	22984239	0	11	0	12	23
X	22984267	0	7	0	20	27
X	22984352	0	6	0	28	34
X	23024266	0	0	0	0	0
X	23029207	2	0	1	0	3
X	23206974	0	0	0	0	0
Y	400261	0	0	0	0	0
Y	688072	0	0	0	0	0
Y_CP007107v1_random	40134	0	0	0	0	0
Y_DS485767v1_random	101	0	0	0	0	0
