#CHR	POS	Count_A	Count_C	Count_G	Count_T	Good_depth
2R	669894	0	0	0	0	0
2R	927745	0	27	0	32	59
2R	927747	0	15	0	46	61
2R	927763	0	11	0	46	57
2R	927764	0	30	0	29	59
2R	927773	0	35	0	18	53
2R	928819	0	99	0	34	133
2R	928861	0	12	0	116	128
2R	928866	0	76	0	48	124
2R	928867	0	18	0	110	128
2R	946817	0	2	0	14	16
2R	947223	0	0	0	4	4
2R	948265	0	1	0	5	6
2R	949521	0	1	0	3	4
2R	1268441	6	0	5	1	12
2R	1271549	0	0	0	0	0
2R	1362581	0	0	0	0	0
2R	1397455	1	0	0	0	1
2R	1424437	2	0	0	0	2
2R	1424453	2	0	0	0	2
2R	1591958	16	0	1	0	17
2R	1593302	24	0	1	0	25
2R	1593303	19	0	5	0	24
2R	1593310	19	0	5	0	24
2R	1593315	22	0	4	0	26
2R	1593825	14	0	0	0	14
2R	1594032	19	0	0	0	19
2R	1595342	5	0	3	0	8
2R	1595440	9	0	3	0	12
2R	1607075	0	0	0	0	0
2R	1728919	0	0	0	0	0
2R	1738108	0	0	0	0	0
2R	1865062	0	1	0	9	10
2R	1865075	0	0	0	8	8
2R	1865085	0	8	0	1	9
2R	1865087	0	3	0	5	8
2R	1865348	0	1	0	9	10
2R	1865369	0	3	0	8	11
2R	1865574	0	1	0	3	4
2R	1873696	0	0	0	0	0
2R	1891695	0	1	0	1	2
2R	1893555	0	0	0	0	0
2R	1895974	0	0	0	0	0
2R	1905603	0	0	0	0	0
2R	1916341	0	0	0	0	0
2R	1917254	0	0	0	0	0
2R	1958846	0	0	0	1	1
2R	1986061	0	0	0	0	0
2R	1994663	0	1	0	1	2
2R	1994676	0	0	0	2	2
2R	2080600	0	0	0	0	0
2R	2108301	0	1	0	1	2
2R	2191810	0	0	0	0	0
2R	2194077	0	0	0	0	0
2R	2195782	0	0	0	0	0
2R	2202217	0	0	0	0	0
2R	2202225	0	0	0	0	0
2R	2241894	0	0	0	0	0
2R	2246575	0	0	0	0	0
2R	2246585	0	0	0	0	0
2R	2246586	0	0	0	0	0
2R	2246597	0	0	0	0	0
2R	2246605	0	0	0	0	0
2R	2246607	0	0	0	0	0
2R	2246610	0	0	0	0	0
2R	2246614	0	0	0	0	0
2R	2246619	0	0	0	0	0
2R	2246626	0	0	0	0	0
2R	2246628	0	0	0	0	0
2R	2246630	0	0	0	0	0
2R	2246649	0	0	0	0	0
2R	2246650	0	0	0	0	0
2R	2246657	0	0	0	0	0
2R	2246661	0	0	0	0	0
2R	2246666	0	0	0	0	0
2R	2246668	0	0	0	0	0
2R	2246670	0	0	0	0	0
2R	2246672	0	0	0	0	0
2R	2246674	0	0	0	0	0
2R	2246677	0	0	0	0	0
2R	2246691	0	0	0	0	0
2R	2246694	0	0	0	0	0
2R	2246705	0	0	0	0	0
2R	2246718	0	0	0	0	0
2R	2246721	0	0	0	0	0
2R	2246725	0	0	0	0	0
2R	2246749	0	0	0	0	0
2R	2246751	0	0	0	0	0
2R	2246758	0	0	0	0	0
2R	2247749	0	0	0	0	0
2R	2256918	0	0	0	1	1
2R	2257284	0	0	0	0	0
2R	2257289	0	0	0	0	0
2R	2257295	0	0	0	0	0
2R	2257742	0	0	0	0	0
2R	2257793	0	0	0	0	0
2R	2257825	0	1	0	0	1
2R	2257846	0	0	0	1	1
2R	2260195	0	0	0	7	7
2R	2260208	0	0	0	9	9
2R	2260246	0	0	0	11	11
2R	2260647	0	1	0	1	2
2R	2487897	0	0	0	0	0
2R	2487913	0	0	0	0	0
2R	2495761	0	6	0	36	42
2R	2496768	0	23	0	27	50
2R	2496780	0	33	0	11	44
2R	2498338	0	1	0	12	13
2R	2498339	0	1	0	13	14
2R	2498347	0	12	0	2	14
2R	2498348	0	1	0	14	15
2R	2498350	0	7	0	7	14
2R	2498351	0	6	0	9	15
2R	2498353	0	9	0	6	15
2R	2498356	0	12	0	3	15
2R	2498359	0	5	0	8	13
2R	2498363	0	7	0	9	16
2R	2498364	0	4	0	11	15
2R	2517609	0	1	0	18	19
2R	2519999	0	9	0	8	17
2R	2554231	0	0	0	3	3
2R	2554519	0	2	0	1	3
2R	2554530	0	2	0	1	3
2R	2562370	0	6	0	1	7
2R	2562467	0	4	0	4	8
2R	2563510	0	0	0	6	6
2R	2640746	0	0	0	0	0
2R	2820914	0	0	0	1	1
2R	2821043	0	0	0	1	1
2R	2822225	0	1	0	1	2
2R	2822367	0	0	0	2	2
2R	2822866	0	0	0	2	2
2R	2822867	0	1	0	1	2
2R	2822874	0	0	0	1	1
2R	2822875	0	0	0	2	2
2R	2822877	0	1	0	1	2
2R	2822880	0	1	0	1	2
2R	2822883	0	0	0	2	2
2R	2822884	0	0	0	2	2
2R	2822887	0	1	0	1	2
2R	2822888	0	1	0	1	2
2R	2822893	0	1	0	1	2
2R	2822941	0	0	0	1	1
2R	2822942	0	0	0	1	1
2R	2822956	0	0	0	1	1
2R	2822957	0	0	0	1	1
2R	2822958	0	0	0	1	1
2R	2822961	0	0	0	1	1
2R	2822991	0	0	0	1	1
2R	2822995	0	0	0	1	1
2R	2822996	0	0	0	1	1
2R	2822997	0	0	0	1	1
2R	2823003	0	0	0	1	1
2R	2823005	0	0	0	1	1
2R	2823006	0	0	0	1	1
2R	2823007	0	0	0	1	1
2R	2823097	0	0	0	1	1
2R	2823428	0	0	0	0	0
2R	2823645	0	0	0	1	1
2R	2823852	0	1	0	1	2
2R	2831098	0	1	0	1	2
2R	2831110	0	2	0	0	2
2R	2832245	0	0	0	2	2
2R	2843105	0	1	0	0	1
2R	2843112	0	1	0	1	2
2R	2843113	0	0	0	2	2
2R	2843121	0	1	0	1	2
2R	2843122	0	1	0	1	2
2R	2843124	0	0	0	2	2
2R	2843130	0	1	0	1	2
2R	2846308	0	2	0	5	7
2R	2954347	0	0	0	0	0
2R	2954369	0	0	0	0	0
2R	2954754	0	0	0	0	0
2R	2970910	0	0	1	0	1
2R	3104182	0	0	0	0	0
2R	3190285	10	0	9	0	19
2R	3919432	0	1	0	2	3
2R	3932880	0	1	0	0	1
2R	3941840	0	9	0	4	13
2R	4052078	2	0	0	0	2
2R	4052143	1	0	1	0	2
2R	4052192	0	0	0	0	0
2R	4052205	0	0	0	0	0
2R	4052208	0	0	0	0	0
2R	4052224	0	0	0	0	0
2R	4052238	0	0	0	0	0
2R	4052252	0	0	0	0	0
2R	4052268	0	0	0	0	0
2R	4052279	0	0	0	0	0
2R	4220796	0	0	0	0	0
2R	4350268	0	1	0	0	1
2R	4350386	0	0	0	1	1
2R	4367099	0	0	0	0	0
2R	4397570	0	0	0	0	0
2R	4397571	0	0	0	0	0
2R	4397577	0	0	0	0	0
2R	4397580	0	0	0	0	0
2R	4397583	0	0	0	0	0
2R	4397588	0	0	0	0	0
2R	4397601	0	0	0	0	0
2R	4397632	0	0	0	0	0
2R	4397638	0	0	0	0	0
2R	4397643	0	0	0	0	0
2R	4397645	0	0	0	0	0
2R	4397646	0	0	0	0	0
2R	4397658	0	0	0	0	0
2R	4407456	0	0	0	0	0
2R	4407479	0	0	0	0	0
2R	4470411	0	0	0	1	1
2R	4598137	1	0	4	0	5
2R	4610290	0	0	0	0	0
2R	4610327	1	0	0	0	1
2R	4610328	1	0	0	0	1
2R	4610335	1	0	0	0	1
2R	4610338	1	0	0	0	1
2R	4610340	1	0	0	0	1
2R	4610343	0	0	1	0	1
2R	4610344	0	0	1	0	1
2R	4749085	12	0	3	0	15
2R	4787711	0	15	0	83	98
2R	4790435	1	0	0	0	1
2R	4795353	0	0	0	1	1
2R	5027097	0	0	0	0	0
2R	5068277	0	5	0	2	7
2R	5069358	0	0	0	5	5
2R	5069359	0	0	0	5	5
2R	5069360	0	0	0	5	5
2R	5119406	0	7	0	7	14
2R	5120152	0	3	0	4	7
2R	5124254	0	0	0	1	1
2R	5127276	0	2	0	4	6
2R	5211451	0	0	0	0	0
2R	5302757	0	0	0	0	0
2R	5320850	4	0	1	0	5
2R	5337012	0	0	0	0	0
2R	5495400	0	0	0	13	13
2R	5503750	0	0	0	0	0
2R	5503767	0	0	0	0	0
2R	5503911	0	0	0	0	0
2R	5503915	0	0	0	0	0
2R	5504022	0	0	0	0	0
2R	5504026	0	0	0	0	0
2R	5504425	0	0	0	0	0
2R	5504526	0	0	0	0	0
2R	5505677	0	0	0	0	0
2R	5505735	0	0	0	0	0
2R	5505798	0	0	0	0	0
2R	5505800	0	0	0	0	0
2R	5505852	0	0	0	0	0
2R	6031677	0	0	0	2	2
2R	6039689	0	14	0	9	23
2R	6174962	415	0	0	0	415
2R	6571523	0	0	0	0	0
2R	6725344	0	1	0	37	38
2R	6733080	0	1	0	37	38
2R	6733220	0	2	0	44	46
2R	6817728	11	0	2	0	13
2R	6927455	0	3	0	33	36
2R	7130316	0	0	0	8	8
2R	7401894	0	0	0	0	0
2R	7501178	9	0	65	0	74
2R	7502188	9	0	24	0	33
2R	7502199	9	0	19	0	28
2R	7664923	10	0	0	0	10
2R	7813863	58	0	66	0	124
2R	8100701	41	0	18	0	59
2R	8144501	0	0	0	1	1
2R	8464487	122	0	0	0	122
2R	8482655	0	1	0	35	36
2R	8511471	0	2	0	0	2
2R	8616059	123	0	0	0	123
2R	8618670	243	0	0	0	243
2R	8696454	8	0	0	0	8
2R	8876533	73	0	16	0	89
2R	8876790	81	0	13	0	94
2R	8877577	101	0	12	0	113
2R	8883706	0	0	99	0	99
2R	8883745	64	0	45	0	109
2R	8885231	63	0	25	0	88
2R	8885377	62	0	37	0	99
2R	8903673	1113	0	72	0	1185
2R	8903674	1053	0	83	0	1136
2R	8903680	951	0	272	1	1224
2R	8912445	0	0	0	3	3
2R	9100226	13	0	0	0	13
2R	9110821	8	0	0	0	8
2R	9119427	21	0	0	0	21
2R	9120392	15	0	55	0	70
2R	9158865	0	0	0	16	16
2R	9168104	0	0	0	39	39
2R	9171291	0	0	0	27	27
2R	9171360	0	0	0	28	28
2R	9191664	0	0	0	129	129
2R	9229669	0	33	0	193	226
2R	9229804	0	146	2	391	539
2R	9229936	0	214	0	323	537
2R	9232371	0	0	0	21	21
2R	9234514	0	295	0	197	492
2R	9234519	0	341	0	131	472
2R	9311068	0	8	0	120	128
2R	9312080	0	32	0	41	73
2R	9312087	0	40	0	37	77
2R	9312091	0	0	0	77	77
2R	9312092	75	0	0	0	75
2R	9312093	0	0	0	73	73
2R	9312094	0	5	0	71	76
2R	9328201	0	1	0	4	5
2R	9344191	0	0	0	2	2
2R	9344213	0	1	0	0	1
2R	9345714	0	0	0	5	5
2R	9369253	0	1	0	2	3
2R	9408179	0	1	0	0	1
2R	9440747	0	46	0	20	66
2R	9534930	171	0	82	0	253
2R	9534943	249	0	33	0	282
2R	9539059	0	203	0	36	239
2R	9542736	0	2	0	2	4
2R	9542851	0	3	0	5	8
2R	9592745	2	0	0	0	2
2R	9598728	12	0	0	0	12
2R	9599645	3	0	0	0	3
2R	9619360	0	0	0	1	1
2R	9633098	0	0	0	1	1
2R	9721527	0	2	0	5	7
2R	9723564	0	4	0	31	35
2R	9739197	0	0	0	0	0
2R	9753896	959	0	33	0	992
2R	9817692	0	0	0	22	22
2R	9819309	0	4	0	16	20
2R	9819328	0	3	0	14	17
2R	9819477	0	1	0	24	25
2R	9819490	0	10	0	14	24
2R	9884160	0	22	1	162	185
2R	9927725	0	0	0	0	0
2R	10011276	0	0	0	0	0
2R	10091619	14	0	0	0	14
2R	10108800	696	0	369	0	1065
2R	10108801	761	0	307	0	1068
2R	10108802	858	0	210	0	1068
2R	10222721	0	1	0	7	8
2R	10278408	9	0	1	0	10
2R	10279089	27	0	0	0	27
2R	10280883	40	0	41	0	81
2R	10280988	32	0	56	0	88
2R	10285619	100	0	0	0	100
2R	10321544	8	0	0	0	8
2R	10327175	0	14	0	11	25
2R	10330783	0	1	0	6	7
2R	10330787	0	6	0	3	9
2R	10330795	0	1	0	8	9
2R	10330796	0	0	0	10	10
2R	10330801	0	5	0	5	10
2R	10330802	0	4	0	6	10
2R	10336774	0	9	0	54	63
2R	10378403	0	0	0	1	1
2R	10378432	0	0	0	0	0
2R	10378433	0	0	0	0	0
2R	10392192	0	0	0	13	13
2R	10393990	0	0	0	8	8
2R	10472135	0	43	0	169	212
2R	10531606	0	1	0	1	2
2R	10540485	0	0	0	1	1
2R	10611461	158	0	16	0	174
2R	10611464	135	0	27	0	162
2R	10706747	14	0	1	0	15
2R	10783584	0	0	0	0	0
2R	10785766	0	3	0	0	3
2R	10785846	0	0	0	6	6
2R	10788717	1	0	0	0	1
2R	10789955	2	0	0	0	2
2R	10815342	52	0	0	0	52
2R	10837913	0	440	0	0	440
2R	10840470	0	107	0	25	132
2R	10855471	0	0	0	0	0
2R	11148789	0	0	0	52	52
2R	11229833	0	0	0	145	145
2R	11293045	0	19	0	32	51
2R	11447601	48	0	335	0	383
2R	11447607	4	1	403	0	408
2R	11447617	66	0	357	1	424
2R	11447623	93	0	353	0	446
2R	11447933	430	0	0	0	430
2R	11447935	401	0	31	1	433
2R	11447987	282	0	179	0	461
2R	11450317	199	0	241	0	440
2R	11450318	212	0	225	0	437
2R	11603464	0	0	0	0	0
2R	11635584	0	0	0	0	0
2R	11635585	0	0	0	0	0
2R	11635587	0	0	0	0	0
2R	11635588	0	0	0	0	0
2R	11671280	0	0	0	4	4
2R	11779856	0	0	0	0	0
2R	11827392	0	0	0	10	10
2R	11845525	33	0	5	0	38
2R	11893047	7	0	0	0	7
2R	11990709	24	0	6	0	30
2R	12024356	0	1	0	6	7
2R	12025551	0	3	0	3	6
2R	12025588	0	4	0	0	4
2R	12265428	6	0	1	0	7
2R	12269039	14	0	0	0	14
2R	12328060	36	0	0	0	36
2R	12328068	41	0	0	0	41
2R	12328073	39	0	0	0	39
2R	12329738	0	0	0	0	0
2R	12350262	1	0	0	0	1
2R	12448654	84	0	34	0	118
2R	12448686	76	0	58	0	134
2R	12448723	111	0	55	0	166
2R	12448779	92	0	99	0	191
2R	12469039	6	0	0	0	6
2R	12470834	8	0	0	0	8
2R	12489327	0	0	0	77	77
2R	12648195	0	0	0	3	3
2R	12754897	0	2	0	0	2
2R	12758582	44	0	94	0	138
2R	12800608	3	0	28	0	31
2R	12800859	34	0	5	0	39
2R	12921246	189	0	147	0	336
2R	12921325	240	0	167	0	407
2R	12921326	325	0	83	0	408
2R	13437401	0	0	0	13	13
2R	13517261	0	12	0	112	124
2R	13517274	0	43	0	73	116
2R	13517275	0	83	0	31	114
2R	13517347	1	28	0	70	99
2R	13580366	1	0	0	0	1
2R	13747628	4	0	39	0	43
2R	13748897	0	0	47	0	47
2R	13809071	25	0	8	0	33
2R	13809547	24	0	109	0	133
2R	13809607	80	0	53	0	133
2R	13809962	126	0	78	0	204
2R	13810199	87	0	63	0	150
2R	13817109	130	0	64	0	194
2R	13817124	165	0	9	0	174
2R	13817379	25	1	200	0	226
2R	13823895	0	1	0	74	75
2R	13846257	2	0	0	0	2
2R	13858942	0	0	0	0	0
2R	13885952	0	0	0	95	95
2R	13886458	0	17	0	70	87
2R	13887556	0	55	0	37	92
2R	13893580	0	14	0	57	71
2R	13893934	0	28	0	21	49
2R	13916837	0	0	0	0	0
2R	13974052	0	0	0	35	35
2R	14062507	0	13	0	85	98
2R	14062651	0	54	0	46	100
2R	14062768	0	35	0	79	114
2R	14062771	0	55	0	55	110
2R	14062774	0	21	0	88	109
2R	14149035	0	0	0	74	74
2R	14152423	0	5	0	0	5
2R	14153104	0	2	0	0	2
2R	14171351	19	0	0	0	19
2R	14172781	181	0	60	0	241
2R	14178731	157	0	54	0	211
2R	14182106	66	0	23	0	89
2R	14215739	0	0	0	4	4
2R	14297994	350	0	100	0	450
2R	14331618	0	0	0	0	0
2R	14334547	1	0	0	0	1
2R	14355520	21	0	5	0	26
2R	14361978	4	5	0	0	9
2R	14507629	56	0	0	0	56
2R	14538499	0	0	0	0	0
2R	14555183	0	0	0	0	0
2R	14740426	0	13	0	227	240
2R	14741592	0	154	0	97	251
2R	14742174	0	19	0	414	433
2R	14742210	1	140	0	293	434
2R	14742223	0	101	0	318	419
2R	14742241	0	135	0	264	399
2R	14742359	0	0	0	364	364
2R	14756598	340	0	2	0	342
2R	14762018	1	113	0	132	246
2R	14971913	0	0	105	0	105
2R	15264046	0	45	0	40	85
2R	15264051	0	36	0	46	82
2R	15264096	0	68	0	17	85
2R	15264743	0	25	0	50	75
2R	15415679	20	0	3	0	23
2R	15456269	11	0	2	0	13
2R	15460575	15	0	6	0	21
2R	15460578	18	0	3	0	21
2R	15516140	0	0	0	74	74
2R	15518712	1	44	0	67	112
2R	15765728	0	0	0	29	29
2R	15766457	0	0	0	27	27
2R	15772754	0	0	0	2	2
2R	15772755	0	0	0	2	2
2R	15775053	0	1	0	27	28
2R	15777061	0	6	0	3	9
2R	15779915	0	1	0	0	1
2R	15779918	0	0	0	1	1
2R	15779987	0	1	0	0	1
2R	15779998	0	0	0	0	0
2R	15786556	0	0	0	0	0
2R	15809225	0	0	0	0	0
2R	15871835	0	50	0	17	67
2R	15872366	0	93	0	30	123
2R	15980167	0	0	0	11	11
2R	16336488	8	0	5	0	13
2R	16432544	14	0	0	0	14
2R	16534056	0	0	0	0	0
2R	16576409	0	218	0	0	218
2R	16647491	54	0	8	0	62
2R	16647492	8	0	55	0	63
2R	16647565	67	0	13	0	80
2R	16647597	69	0	12	0	81
2R	16647631	14	0	70	0	84
2R	16650664	51	0	0	0	51
2R	16650669	54	0	0	0	54
2R	16650728	59	0	0	0	59
2R	16650742	59	0	1	0	60
2R	16650776	36	0	29	0	65
2R	16650779	58	0	5	0	63
2R	16650790	36	0	34	0	70
2R	16650805	52	0	13	0	65
2R	16650890	62	0	4	0	66
2R	16762451	0	0	0	2	2
2R	16765101	0	0	0	22	22
2R	16917584	0	0	0	0	0
2R	16932924	13	0	0	0	13
2R	17222715	0	0	0	0	0
2R	17364649	9	0	7	0	16
2R	17374869	30	0	39	0	69
2R	17375028	71	0	36	0	107
2R	17375029	86	0	18	0	104
2R	17375057	43	0	53	0	96
2R	17375058	65	0	29	0	94
2R	17377109	30	0	131	0	161
2R	17377110	34	0	129	0	163
2R	17377122	57	0	108	0	165
2R	17377125	88	0	74	1	163
2R	17377403	84	0	51	0	135
2R	17701194	0	0	0	0	0
2R	18020907	0	0	0	0	0
2R	18134284	0	0	0	9	9
2R	18145289	7	0	0	0	7
2R	18167781	159	0	0	0	159
2R	18173890	36	0	0	0	36
2R	18281192	0	0	0	66	66
2R	18356868	0	6	0	9	15
2R	18518047	3	0	4	0	7
2R	18518048	3	0	4	0	7
2R	18720854	0	0	0	0	0
2R	18743376	0	0	0	0	0
2R	18865057	0	0	0	0	0
2R	18998450	13	0	0	0	13
2R	19006082	79	0	53	0	132
2R	19006586	0	0	0	0	0
2R	19138221	0	0	0	1	1
2R	19139754	107	0	0	0	107
2R	19179174	14	0	5	0	19
2R	19223379	57	0	14	0	71
2R	19223636	48	0	57	0	105
2R	19225658	106	0	40	0	146
2R	19303685	62	0	10	0	72
2R	19326309	0	29	0	12	41
2R	19525936	0	0	0	36	36
2R	19566903	0	2	0	17	19
2R	19625834	0	0	0	0	0
2R	19727230	0	0	0	0	0
2R	20424540	64	0	0	0	64
2R	20658504	0	0	14	0	14
2R	21145178	385	0	38	0	423
2R	21315686	76	1	35	0	112
2R	21334960	7	0	9	0	16
2R	21480214	0	13	0	59	72
2R	21557174	9	0	53	0	62
2R	21620849	0	26	0	31	57
2R	21621075	0	30	0	24	54
2R	21653466	59	0	67	0	126
2R	21851363	0	0	0	0	0
2R	22175545	33	0	0	0	33
2R	22227209	0	0	0	37	37
2R	22391510	24	0	84	0	108
2R	22564373	0	30	0	54	84
2R	22564377	0	32	0	55	87
2R	22568445	0	0	0	1	1
2R	22573070	0	1	0	0	1
2R	22587796	0	0	0	0	0
2R	22637905	65	0	0	0	65
2R	22673075	16	0	0	0	16
2R	22746263	0	1	0	3	4
2R	23381950	0	0	0	46	46
2R	23598132	18	0	1	0	19
2R	23804970	0	0	0	0	0
2R	23838782	33	0	2	0	35
2R	23844274	0	0	0	48	48
2R	23867196	0	0	0	232	232
2R	24006102	0	3	0	74	77
2R	24006115	0	0	0	73	73
2R	24006555	0	69	0	8	77
2R	24046125	0	0	0	0	0
2R	24050977	30	0	25	0	55
2R	24051555	63	0	4	0	67
2R	24218949	0	0	0	1	1
2R	24332337	0	0	0	0	0
2R	24384812	0	62	0	3	65
2R	24419247	0	160	0	17	177
2R	24419250	0	155	0	20	175
2R	24500965	0	0	0	0	0
2R	24512318	0	27	0	55	82
2R	24882682	127	0	17	0	144
2R	24882751	109	0	45	0	154
2R	24885850	90	0	18	0	108
2R	24904717	153	0	24	0	177
2R	24910398	140	0	125	0	265
2R	24910568	146	0	88	0	234
2R	24910752	125	0	29	0	154
2R	24910775	26	0	124	0	150
2R	24910814	102	0	93	0	195
2R	24910823	91	0	111	0	202
2R	24911061	68	0	110	0	178
2R	24911109	72	0	110	0	182
2R	24912004	106	0	37	1	144
2R	24912848	45	0	178	0	223
2R	24912923	228	0	0	0	228
2R	24914689	162	0	29	0	191
2R	24914702	50	0	134	0	184
2R	24914794	41	0	117	0	158
2R	24914829	154	0	13	0	167
2R	24914858	9	0	171	0	180
2R	24914859	166	0	13	0	179
2R	24914864	40	0	147	0	187
2R	24914865	57	0	130	0	187
2R	24914874	75	0	118	0	193
2R	24919093	197	0	34	0	231
2R	24920153	124	0	3	0	127
2R	24995597	0	36	0	71	107
2R	24995857	0	47	0	65	112
2R	25255069	41	0	10	0	51
2R	25255079	27	0	28	0	55
2R	25255082	23	0	32	0	55
2R	25255913	66	0	15	0	81
2R	25256658	24	0	27	0	51
2R	25257110	31	0	2	0	33
2R	25257267	22	0	41	0	63
2R	25257297	47	0	18	0	65
2R	25257312	24	0	40	0	64
2R	25257313	13	0	52	0	65
2R	25257314	27	0	36	1	64
2R	25257317	35	0	33	0	68
2R	25257328	43	0	21	0	64
2R	25257336	53	0	9	0	62
2R	25257337	52	0	11	0	63
2R	25257342	10	0	58	0	68
2R	25257343	12	0	56	0	68
2R	25257375	72	0	2	0	74
2R	25257376	65	0	9	0	74
2R	25257377	46	0	28	0	74
2R	25257383	41	0	37	0	78
2R	25257388	46	0	29	0	75
2R	25257391	57	0	24	0	81
2R	25257392	62	0	18	0	80
2R	25257393	77	0	5	0	82
2R	25257394	57	0	23	0	80
2R	25257396	84	0	2	0	86
2R	25257397	68	0	18	0	86
2R	25257398	65	0	19	0	84
2R	25257404	26	0	53	0	79
2R	25257405	19	0	60	0	79
2R	25257406	43	0	35	0	78
2R	25257414	68	0	12	0	80
2R	25257417	38	0	42	0	80
2R	25257418	39	0	40	0	79
2R	25257420	67	0	11	0	78
2R	25257424	75	0	11	0	86
2R	25257425	25	0	62	0	87
2R	25257426	18	0	70	0	88
2R	25257427	68	0	22	0	90
2R	25257431	81	0	9	0	90
2R	25257439	81	0	13	0	94
2R	25257445	60	0	20	0	80
2R	25257451	34	0	51	0	85
2R	25257453	75	0	9	0	84
2R	25257483	64	0	20	0	84
2R	25257508	42	0	52	0	94
2R	25257625	60	0	6	0	66
2R	25257632	58	0	8	0	66
2R	25257633	62	0	2	0	64
2R	25257638	66	0	0	0	66
2R	25257643	42	0	20	0	62
2R	25257682	17	0	25	0	42
2R	25257683	21	0	20	0	41
2R	25257699	31	0	5	0	36
2R	25257701	22	0	11	0	33
2R	25257703	14	0	18	0	32
2R	25257714	17	1	19	0	37
2R	25257732	25	0	18	0	43
2R	25257735	30	0	13	0	43
2R	25257740	28	0	17	0	45
2R	25257741	35	0	11	0	46
2R	25257743	41	0	5	0	46
2R	25257781	30	0	16	0	46
2R	25257788	45	0	1	0	46
2R	25257789	45	0	2	0	47
2R	25257792	40	0	6	0	46
2R	25257806	17	0	22	0	39
2R	25257812	29	0	8	0	37
2R	25257820	27	0	10	0	37
2R	25257832	19	0	14	0	33
2R	25257836	11	0	22	0	33
2R	25257964	2	0	10	0	12
3L	71000	0	0	0	0	0
3L	214328	0	42	0	0	42
3L	226141	2334	0	138	0	2472
3L	271201	0	0	0	0	0
3L	336697	2	0	0	0	2
3L	346424	2	0	0	0	2
3L	346882	0	0	0	8	8
3L	411895	0	0	0	0	0
3L	462074	0	0	0	0	0
3L	498116	0	0	0	0	0
3L	546751	0	0	0	0	0
3L	575217	67	0	0	0	67
3L	598790	9	0	7	0	16
3L	991441	89	0	41	0	130
3L	1010857	0	0	1	0	1
3L	1011246	0	0	0	0	0
3L	1011285	0	0	0	0	0
3L	1026639	0	12	0	75	87
3L	1027109	0	42	0	87	129
3L	1033059	0	0	0	0	0
3L	1034384	0	8	0	4	12
3L	1034386	0	7	0	5	12
3L	1044064	2	0	0	0	2
3L	1046651	0	0	0	0	0
3L	1135014	0	0	0	0	0
3L	1138357	0	0	0	0	0
3L	1210848	1	0	0	0	1
3L	1217228	2	0	0	0	2
3L	1227904	0	0	0	0	0
3L	1230644	0	0	39	0	39
3L	1318745	0	2	0	0	2
3L	1407143	0	0	0	0	0
3L	1490348	0	1	0	5	6
3L	1526045	0	0	0	4	4
3L	1556299	0	0	0	188	188
3L	1689558	42	0	0	0	42
3L	1727806	0	1	0	0	1
3L	1782670	0	250	0	198	448
3L	1945203	0	0	0	6	6
3L	2001719	0	0	0	0	0
3L	2039782	0	1	0	49	50
3L	2039908	0	26	0	78	104
3L	2039918	0	35	0	69	104
3L	2039919	0	12	0	97	109
3L	2042849	0	0	0	117	117
3L	2043519	0	0	0	122	122
3L	2044551	0	0	0	96	96
3L	2044916	0	0	0	102	102
3L	2045959	0	0	0	92	92
3L	2051548	0	0	0	50	50
3L	2054348	0	0	0	6	6
3L	2055902	0	0	0	6	6
3L	2056964	0	0	0	3	3
3L	2060460	0	0	0	11	11
3L	2074107	0	0	0	22	22
3L	2080672	0	35	0	0	35
3L	2080891	0	20	0	0	20
3L	2089039	0	0	0	27	27
3L	2096769	0	103	0	0	103
3L	2125496	0	2	0	187	189
3L	2126093	0	36	0	161	197
3L	2134649	0	6	0	74	80
3L	2135049	0	0	0	129	129
3L	2190111	0	0	0	55	55
3L	2245947	0	0	0	0	0
3L	2251644	0	0	0	0	0
3L	2348350	0	0	0	0	0
3L	2372937	0	0	31	0	31
3L	2377732	0	0	0	1	1
3L	2390472	0	0	0	0	0
3L	2424958	0	0	0	1	1
3L	2440451	1	0	0	0	1
3L	2458238	8	0	0	0	8
3L	2469405	0	0	0	0	0
3L	2469912	0	0	0	0	0
3L	2473344	0	0	0	0	0
3L	2481805	3	0	0	0	3
3L	2498728	0	0	0	75	75
3L	2499964	1	0	0	1082	1083
3L	2519293	0	0	0	0	0
3L	2578670	0	0	0	0	0
3L	2657532	0	0	0	103	103
3L	2665990	0	17	0	45	62
3L	2666151	0	52	0	5	57
3L	2773256	1	0	0	63	64
3L	2773526	0	0	0	46	46
3L	2777176	38	0	0	0	38
3L	2778433	43	0	0	0	43
3L	2778439	47	0	0	0	47
3L	2784069	0	11	0	0	11
3L	2784359	0	0	14	0	14
3L	2785524	0	0	16	0	16
3L	2785531	0	0	0	15	15
3L	2785536	0	0	0	14	14
3L	2785542	0	15	0	0	15
3L	2785610	0	17	0	0	17
3L	2785621	0	0	0	16	16
3L	2785658	15	0	0	0	15
3L	2786034	0	0	0	0	0
3L	2791593	0	0	0	55	55
3L	2799685	0	2	0	0	2
3L	2882059	0	0	0	0	0
3L	2924789	183	0	16	1	200
3L	2924790	187	0	16	0	203
3L	2924829	160	1	53	0	214
3L	2925090	56	0	120	0	176
3L	2925255	16	0	129	0	145
3L	2925550	43	0	0	0	43
3L	2939953	62	0	35	0	97
3L	2940825	216	1	5	0	222
3L	2940919	172	0	31	0	203
3L	2941131	42	0	167	0	209
3L	2941132	14	0	196	0	210
3L	2941311	136	0	10	0	146
3L	2941312	10	0	142	0	152
3L	2941364	10	0	143	0	153
3L	2941396	29	0	110	0	139
3L	2941425	59	0	96	0	155
3L	2941426	7	0	149	0	156
3L	2961305	0	0	0	0	0
3L	3086223	180	0	51	0	231
3L	3114961	0	0	0	63	63
3L	3150180	0	0	0	0	0
3L	3226015	19	0	8	0	27
3L	3311439	0	0	0	0	0
3L	3359345	48	0	29	0	77
3L	3361215	0	104	0	0	104
3L	3371858	0	70	0	50	120
3L	3371901	0	50	0	77	127
3L	3371976	0	34	0	122	156
3L	3407053	0	0	0	3	3
3L	3442381	0	0	0	1	1
3L	3471786	0	0	0	67	67
3L	3555912	1	0	0	0	1
3L	3729820	0	0	0	0	0
3L	3761976	0	0	0	7	7
3L	3762337	0	0	0	3	3
3L	3781259	0	0	0	37	37
3L	3786975	0	0	0	0	0
3L	3815844	0	0	1	0	1
3L	3837134	0	0	139	0	139
3L	3892642	0	0	65	0	65
3L	3904309	1	0	0	0	1
3L	3988087	91	0	18	0	109
3L	4089220	0	0	0	3	3
3L	4092326	567	1	3	1	572
3L	4172458	45	0	0	0	45
3L	4198341	23	0	27	0	50
3L	4264563	0	0	0	0	0
3L	4307932	1	0	0	0	1
3L	4308806	0	0	0	0	0
3L	4314575	0	0	0	0	0
3L	4314576	0	0	0	0	0
3L	4314586	0	0	0	0	0
3L	4316475	0	0	0	0	0
3L	4317484	0	0	0	0	0
3L	4317522	0	0	0	0	0
3L	4317524	0	0	0	0	0
3L	4317564	0	0	0	0	0
3L	4318105	0	0	5	0	5
3L	4318481	0	0	0	0	0
3L	4369162	0	278	0	83	361
3L	4369184	0	280	0	75	355
3L	4369185	0	169	0	187	356
3L	4369207	0	32	0	389	421
3L	4369208	0	26	0	390	416
3L	4369213	0	45	0	381	426
3L	4369313	0	0	0	407	407
3L	4369422	0	96	0	231	327
3L	4369445	0	38	0	252	290
3L	4369455	0	18	0	302	320
3L	4369459	0	32	0	275	307
3L	4429963	23	0	280	0	303
3L	4429967	156	0	147	0	303
3L	4430199	105	0	33	0	138
3L	4430208	20	0	127	0	147
3L	4431761	23	0	206	0	229
3L	4432486	111	0	150	0	261
3L	4432487	50	0	214	0	264
3L	4433319	215	0	129	0	344
3L	4433320	43	0	300	0	343
3L	4446288	0	0	0	0	0
3L	4584256	11	0	77	0	88
3L	4585849	101	0	47	0	148
3L	4585851	125	0	24	0	149
3L	4585858	95	0	50	0	145
3L	4585859	17	0	122	2	141
3L	4585865	85	0	48	0	133
3L	4586039	86	0	9	0	95
3L	4586053	55	0	49	0	104
3L	4586714	377	0	92	0	469
3L	4586715	59	0	396	0	455
3L	4590437	169	0	39	0	208
3L	4590448	161	0	48	0	209
3L	4590461	203	0	23	0	226
3L	4590463	211	0	15	0	226
3L	4590484	201	0	31	0	232
3L	4590685	92	0	155	0	247
3L	4590708	171	0	97	0	268
3L	4590709	51	0	220	0	271
3L	4591116	85	0	127	0	212
3L	4591123	207	0	25	0	232
3L	4591132	207	0	38	0	245
3L	4591179	224	0	42	0	266
3L	4591222	254	0	42	0	296
3L	4591226	307	0	12	0	319
3L	4591259	262	0	21	0	283
3L	4591369	241	0	30	0	271
3L	4591744	253	0	10	0	263
3L	4732441	0	0	0	0	0
3L	4811851	0	0	1	0	1
3L	4822418	76	0	1	1	78
3L	4822420	78	0	0	0	78
3L	4867777	0	0	0	0	0
3L	4897294	0	2	0	0	2
3L	4985909	0	0	0	0	0
3L	4986257	0	0	0	0	0
3L	4986611	0	0	0	0	0
3L	4986891	0	0	0	0	0
3L	5045427	0	0	0	0	0
3L	5102529	0	0	0	0	0
3L	5116849	0	1	0	0	1
3L	5133159	9	0	0	0	9
3L	5133686	0	0	0	0	0
3L	5135062	80	0	1	0	81
3L	5135116	92	0	0	0	92
3L	5139737	40	0	0	0	40
3L	5144164	24	0	0	0	24
3L	5157874	0	16	0	191	207
3L	5160640	0	0	0	114	114
3L	5171594	0	0	0	0	0
3L	5171618	0	0	0	0	0
3L	5185014	0	1	0	2	3
3L	5188016	0	0	0	0	0
3L	5191766	0	0	0	1	1
3L	5192055	0	0	0	0	0
3L	5212866	1	0	0	0	1
3L	5212915	0	2	0	0	2
3L	5212920	0	2	0	0	2
3L	5213133	0	0	0	0	0
3L	5213134	0	0	0	0	0
3L	5247676	0	0	0	9	9
3L	5334897	0	0	0	0	0
3L	5347418	0	0	0	0	0
3L	5435357	0	0	1	0	1
3L	5664597	0	0	0	0	0
3L	5692734	4	0	0	0	4
3L	5696130	20	0	35	0	55
3L	5740525	33	0	50	0	83
3L	5743791	3	0	0	0	3
3L	5745060	50	0	14	0	64
3L	5746701	330	1	0	0	331
3L	5746708	307	0	30	0	337
3L	5746772	286	0	63	0	349
3L	5750034	0	0	0	3	3
3L	5764525	0	0	0	102	102
3L	5815976	0	0	9	0	9
3L	6008890	0	0	0	0	0
3L	6008957	0	0	0	0	0
3L	6009017	0	0	0	0	0
3L	6062381	0	0	0	0	0
3L	6193542	16	0	0	0	16
3L	6285897	0	0	0	0	0
3L	6331348	29	0	0	0	29
3L	6459287	0	0	0	0	0
3L	6506202	0	0	0	0	0
3L	6506212	0	0	0	0	0
3L	6534871	0	0	0	0	0
3L	6641116	0	0	0	0	0
3L	6643565	0	0	0	0	0
3L	6643648	0	0	0	0	0
3L	6643649	0	0	0	0	0
3L	6643749	0	0	0	0	0
3L	6643752	0	0	0	0	0
3L	6689091	0	0	0	0	0
3L	6689204	0	0	0	0	0
3L	6694843	0	0	0	0	0
3L	6734513	53	0	0	0	53
3L	6754914	0	0	0	24	24
3L	6769182	0	0	0	0	0
3L	6786307	0	0	2	0	2
3L	6800394	0	0	6	0	6
3L	6800402	0	0	0	5	5
3L	6949680	0	76	0	398	474
3L	6949683	1	25	0	454	480
3L	6949688	0	96	0	401	497
3L	6949690	0	88	0	410	498
3L	6950110	0	206	1	430	637
3L	6950168	0	59	0	750	809
3L	6954754	0	544	0	702	1246
3L	7021467	0	0	0	0	0
3L	7059577	0	0	0	42	42
3L	7180438	0	48	0	42	90
3L	7218079	0	0	0	0	0
3L	7235679	0	0	0	0	0
3L	7236912	0	0	0	0	0
3L	7324105	0	0	0	18	18
3L	7326096	19	0	0	0	19
3L	7417841	0	0	0	0	0
3L	7650269	0	0	0	0	0
3L	7654672	0	18	0	40	58
3L	7665256	576	0	0	0	576
3L	7666636	0	32	0	33	65
3L	7694236	0	0	0	2	2
3L	7696248	0	1	0	4	5
3L	7830703	0	18	0	17	35
3L	7923214	0	0	0	0	0
3L	7928680	0	91	0	36	127
3L	7939905	0	0	0	0	0
3L	7960324	0	0	0	0	0
3L	7979842	0	0	0	0	0
3L	8041599	0	0	0	0	0
3L	8066395	0	0	0	0	0
3L	8120375	0	0	76	0	76
3L	8120519	0	0	99	0	99
3L	8121502	4	0	0	0	4
3L	8126738	0	0	40	0	40
3L	8126864	20	0	0	0	20
3L	8184846	0	0	31	0	31
3L	8185142	0	0	1	0	1
3L	8228580	0	0	0	0	0
3L	8375374	0	0	0	0	0
3L	8434395	0	0	0	136	136
3L	8444869	0	2	0	0	2
3L	8492631	1	0	0	0	1
3L	8532834	0	0	0	64	64
3L	8532845	0	55	0	0	55
3L	8588267	0	0	144	0	144
3L	8588835	2	0	0	0	2
3L	8589446	4	0	0	0	4
3L	8597507	326	0	0	0	326
3L	8648332	10356	2	0	1	10359
3L	8678627	0	0	62	0	62
3L	8678628	0	0	63	0	63
3L	8678673	0	0	79	0	79
3L	8719077	0	0	19	0	19
3L	8724069	0	0	9	0	9
3L	8736015	0	0	0	3	3
3L	8740095	0	13	0	372	385
3L	8759599	0	0	15	0	15
3L	8775212	0	0	3	0	3
3L	8786152	0	0	71	0	71
3L	8798415	0	0	50	0	50
3L	8827752	0	0	42	0	42
3L	8839904	0	0	0	0	0
3L	8844956	0	0	0	0	0
3L	8850667	0	0	1	0	1
3L	8885355	1	0	0	0	1
3L	8892723	0	0	0	0	0
3L	8913159	0	0	0	0	0
3L	8913856	0	0	0	0	0
3L	8913897	0	0	0	0	0
3L	8931961	20	0	0	0	20
3L	8940166	82	0	0	0	82
3L	8983591	0	182	0	0	182
3L	8985580	0	16	0	0	16
3L	8987752	0	0	0	100	100
3L	8991591	0	27	0	0	27
3L	8993217	0	33	0	2	35
3L	8997822	0	14	0	0	14
3L	9100899	0	4	0	36	40
3L	9124178	0	5	0	7	12
3L	9124180	0	1	0	11	12
3L	9124570	0	0	0	5	5
3L	9144950	212	0	0	0	212
3L	9146324	115	0	0	0	115
3L	9147825	0	2	0	52	54
3L	9149081	0	0	0	78	78
3L	9151835	0	17	0	109	126
3L	9151836	0	7	0	131	138
3L	9155185	0	41	0	113	154
3L	9155218	0	132	0	13	145
3L	9161860	0	4	0	14	18
3L	9161861	0	6	0	14	20
3L	9161863	0	1	0	19	20
3L	9161864	0	0	0	20	20
3L	9161865	0	0	0	20	20
3L	9162917	0	48	0	42	90
3L	9162924	0	22	0	58	80
3L	9172898	0	0	0	0	0
3L	9258715	7	0	0	0	7
3L	9263686	0	0	0	0	0
3L	9270392	0	0	49	0	49
3L	9282077	1	0	0	0	1
3L	9287571	0	0	0	33	33
3L	9341681	10	0	0	0	10
3L	9378596	0	0	0	48	48
3L	9488590	0	0	0	4	4
3L	9497783	0	0	0	0	0
3L	9562249	0	0	0	0	0
3L	9566820	4	0	0	0	4
3L	9566821	4	0	0	0	4
3L	9587305	12	0	0	0	12
3L	9608849	0	1	0	0	1
3L	9622044	0	0	22	0	22
3L	9625888	0	0	10	0	10
3L	9631909	0	23	0	0	23
3L	9632368	0	137	0	0	137
3L	9633307	0	146	0	0	146
3L	9644938	24	0	0	0	24
3L	9645414	0	0	0	21	21
3L	9648209	0	1	0	0	1
3L	9649368	0	1	0	0	1
3L	9666680	0	0	0	0	0
3L	9668976	0	49	0	32	81
3L	9682712	1	0	1	0	2
3L	9682988	0	0	0	0	0
3L	9686533	0	0	0	40	40
3L	9688751	0	0	0	23	23
3L	9709045	1	0	135	0	136
3L	9717933	0	0	0	2	2
3L	9724380	0	0	0	9	9
3L	9724514	0	6	0	0	6
3L	9724607	4	0	0	0	4
3L	9730982	1400	0	0	0	1400
3L	9734333	0	0	0	166	166
3L	9736382	0	0	0	25	25
3L	9736627	0	0	0	0	0
3L	9738180	0	0	0	341	341
3L	9740249	0	0	0	6	6
3L	9740401	0	8	0	0	8
3L	9774568	0	0	0	0	0
3L	9799424	0	0	1	0	1
3L	9807026	0	0	0	0	0
3L	9814841	0	0	0	0	0
3L	9815342	0	0	1	0	1
3L	9816197	0	0	2	0	2
3L	9816249	0	5	0	0	5
3L	9816250	0	0	5	0	5
3L	9816252	0	0	5	0	5
3L	9816265	29	0	0	0	29
3L	9816267	0	0	33	0	33
3L	9817489	0	0	0	0	0
3L	9819018	0	0	0	0	0
3L	9821256	0	0	0	0	0
3L	9821464	0	0	0	0	0
3L	9821472	0	0	0	0	0
3L	9821474	0	0	0	0	0
3L	9821481	0	0	0	0	0
3L	9821685	0	0	0	7	7
3L	9833291	263	0	27	0	290
3L	9833294	206	0	96	0	302
3L	9833300	171	0	135	0	306
3L	9833301	103	0	204	0	307
3L	9833364	261	1	20	0	282
3L	9833369	61	0	232	0	293
3L	9833370	278	0	21	0	299
3L	9833459	177	0	98	0	275
3L	9833484	240	0	26	0	266
3L	9833487	250	0	16	1	267
3L	9867222	70	0	13	0	83
3L	9867339	86	0	130	0	216
3L	9885244	0	16	0	0	16
3L	9885764	0	0	0	11	11
3L	9886836	0	0	0	11	11
3L	9892134	24	0	25	0	49
3L	9943795	0	0	0	0	0
3L	9943907	0	0	0	0	0
3L	9972754	4	0	0	0	4
3L	9974737	12	0	0	0	12
3L	10023375	0	0	0	0	0
3L	10153722	0	0	0	4	4
3L	10182898	0	2	0	1	3
3L	10182954	0	2	0	2	4
3L	10185757	0	3	0	7	10
3L	10197944	0	0	0	0	0
3L	10287759	0	0	3	0	3
3L	10358012	0	1	0	0	1
3L	10423429	0	0	0	0	0
3L	10478991	0	0	0	0	0
3L	10516387	6	0	5	0	11
3L	10556226	0	0	1	0	1
3L	10583448	0	7	0	0	7
3L	10644076	0	0	33	0	33
3L	10659046	0	0	0	1	1
3L	10672257	0	0	0	0	0
3L	10785536	0	0	0	0	0
3L	10787010	1	0	0	0	1
3L	10787012	1	0	0	0	1
3L	10820249	0	0	0	0	0
3L	10848012	0	0	0	0	0
3L	10944093	0	0	0	0	0
3L	11038040	0	6	0	137	143
3L	11067981	29	0	0	0	29
3L	11073860	0	0	0	110	110
3L	11166174	0	9	0	0	9
3L	11166793	12	0	0	0	12
3L	11166799	0	0	0	12	12
3L	11166802	0	0	0	13	13
3L	11166932	0	0	0	22	22
3L	11175776	4	0	0	0	4
3L	11175795	3	0	1	0	4
3L	11175891	3	0	1	0	4
3L	11175895	4	0	1	0	5
3L	11175896	3	0	2	0	5
3L	11176183	2	0	0	0	2
3L	11176185	2	0	0	0	2
3L	11178469	0	0	121	0	121
3L	11203066	0	0	0	24	24
3L	11209891	0	0	28	0	28
3L	11211185	29	0	0	0	29
3L	11211200	22	0	0	0	22
3L	11218031	0	0	0	1	1
3L	11218035	0	0	1	0	1
3L	11218227	0	0	0	0	0
3L	11225111	127	0	0	0	127
3L	11225150	74	0	53	0	127
3L	11280036	0	0	0	0	0
3L	11519814	0	4	0	0	4
3L	11552592	0	1	0	7	8
3L	11553320	0	1	0	1	2
3L	11553330	0	1	0	1	2
3L	11553333	0	1	0	1	2
3L	11559570	0	0	0	0	0
3L	11599583	1	0	0	0	1
3L	11650023	0	0	0	67	67
3L	11670833	0	0	0	0	0
3L	11734662	0	0	0	74	74
3L	11746631	0	0	0	0	0
3L	11764981	0	0	0	0	0
3L	11803246	0	0	0	0	0
3L	11807770	0	0	0	0	0
3L	11815790	0	14	0	0	14
3L	11824846	14	0	0	0	14
3L	11827577	0	0	0	0	0
3L	11837250	0	0	0	0	0
3L	11837265	0	0	0	0	0
3L	11857720	0	0	0	0	0
3L	11857797	0	0	0	0	0
3L	11857887	0	0	1	0	1
3L	11857906	0	0	1	0	1
3L	11956759	0	0	0	0	0
3L	11964188	0	1	0	0	1
3L	11974542	0	0	0	0	0
3L	12022418	0	0	0	1	1
3L	12023402	0	0	0	0	0
3L	12066158	0	0	0	0	0
3L	12070965	0	36	0	0	36
3L	12100697	0	0	0	0	0
3L	12105494	0	0	0	0	0
3L	12123225	0	1	0	627	628
3L	12211671	0	72	0	41	113
3L	12211756	0	16	0	79	95
3L	12212148	0	64	0	1	65
3L	12212309	1	95	0	3	99
3L	12239964	0	0	0	1	1
3L	12244780	0	0	0	0	0
3L	12252166	0	0	0	0	0
3L	12297495	0	0	0	0	0
3L	12423647	0	0	0	0	0
3L	12426521	0	0	0	1	1
3L	12430208	0	0	0	0	0
3L	12440786	0	0	0	0	0
3L	12445033	0	0	0	0	0
3L	12463065	0	0	0	2	2
3L	12463742	0	0	15	0	15
3L	12471180	0	0	0	0	0
3L	12471570	0	0	0	0	0
3L	12493418	0	0	2	0	2
3L	12494398	1	0	0	0	1
3L	12508254	3	0	0	0	3
3L	12508840	0	2	0	0	2
3L	12509140	0	0	0	4	4
3L	12510503	0	0	0	0	0
3L	12519462	112	0	0	0	112
3L	12519598	119	0	0	0	119
3L	12524172	0	0	0	0	0
3L	12527022	0	0	0	0	0
3L	12529862	0	0	0	3	3
3L	12546839	0	0	0	0	0
3L	12691864	0	0	0	0	0
3L	12731393	0	0	0	0	0
3L	12731797	0	0	0	0	0
3L	12768257	16	0	0	0	16
3L	12826688	0	9	0	0	9
3L	12853773	0	0	99	0	99
3L	12856591	43	0	16	0	59
3L	13007953	0	0	0	0	0
3L	13020448	0	27	0	162	189
3L	13038438	25	0	40	0	65
3L	13194742	0	0	0	0	0
3L	13194835	0	0	0	0	0
3L	13195237	0	0	0	0	0
3L	13195308	0	0	0	0	0
3L	13196156	0	0	0	0	0
3L	13196212	0	0	0	0	0
3L	13218792	0	0	0	0	0
3L	13225212	0	0	0	0	0
3L	13309717	0	0	0	0	0
3L	13312105	0	0	0	0	0
3L	13312111	0	0	0	0	0
3L	13418107	0	7	0	1	8
3L	13435185	0	3	0	9	12
3L	13467599	0	71	0	0	71
3L	13467636	0	88	0	0	88
3L	13467653	0	83	0	0	83
3L	13480590	0	0	38	0	38
3L	13492027	0	0	0	1	1
3L	13494294	1	0	0	0	1
3L	13494298	1	0	0	0	1
3L	13494304	0	0	0	0	0
3L	13494305	0	0	0	0	0
3L	13494355	0	0	0	0	0
3L	13494364	0	0	0	0	0
3L	13494365	0	0	0	0	0
3L	13494372	0	0	0	0	0
3L	13494373	0	0	0	0	0
3L	13494374	0	0	0	0	0
3L	13494390	0	0	0	0	0
3L	13494392	0	0	0	0	0
3L	13494408	0	2	0	0	2
3L	13494438	2	0	0	0	2
3L	13494439	0	2	0	0	2
3L	13494441	2	0	0	0	2
3L	13494445	2	0	0	0	2
3L	13494448	2	0	0	0	2
3L	13494451	2	0	0	0	2
3L	13494457	0	0	2	0	2
3L	13494472	0	0	0	2	2
3L	13494497	3	0	0	0	3
3L	13494498	0	0	0	0	0
3L	13494519	0	1	0	0	1
3L	13494520	0	0	0	3	3
3L	13494596	0	0	1	0	1
3L	13494693	1	0	0	0	1
3L	13494842	0	0	29	0	29
3L	13502410	0	0	0	5	5
3L	13535416	13	0	36	0	49
3L	13600286	0	0	0	0	0
3L	13703883	0	0	0	0	0
3L	13858574	24	0	11	0	35
3L	13859907	11	0	0	0	11
3L	13869566	47	0	105	0	152
3L	13871006	0	0	0	31	31
3L	13888962	0	1	0	4	5
3L	13901738	0	107	0	58	165
3L	13912261	0	0	0	1	1
3L	13919434	0	0	0	18	18
3L	13927002	0	0	0	18	18
3L	13929952	16	0	7	0	23
3L	13933146	64	0	0	0	64
3L	13933176	68	0	0	0	68
3L	13959984	7	0	28	0	35
3L	13962782	0	0	0	7	7
3L	13967324	3	0	1	0	4
3L	13974178	45	0	0	0	45
3L	14000997	0	0	0	22	22
3L	14001118	0	7	0	17	24
3L	14063120	0	0	0	0	0
3L	14066713	68	0	0	0	68
3L	14070532	0	0	0	0	0
3L	14071510	0	0	0	6	6
3L	14084672	0	0	0	3	3
3L	14084674	0	0	0	2	2
3L	14090360	0	0	0	0	0
3L	14090416	0	0	0	0	0
3L	14090417	0	0	0	0	0
3L	14096104	0	2	0	0	2
3L	14096107	2	0	0	0	2
3L	14096112	0	2	0	0	2
3L	14096121	0	2	0	0	2
3L	14096133	2	0	0	0	2
3L	14096136	0	0	2	0	2
3L	14096146	2	0	0	0	2
3L	14097465	0	0	0	0	0
3L	14097466	0	0	0	0	0
3L	14097468	0	0	0	0	0
3L	14097688	0	0	0	0	0
3L	14097689	0	0	0	0	0
3L	14097845	0	0	0	0	0
3L	14097870	0	0	0	0	0
3L	14097874	0	0	0	0	0
3L	14098080	0	0	0	0	0
3L	14098096	0	0	0	0	0
3L	14098097	0	0	0	0	0
3L	14098360	0	0	0	0	0
3L	14098377	0	0	0	0	0
3L	14098378	0	0	0	0	0
3L	14098379	0	0	0	0	0
3L	14100722	0	0	0	0	0
3L	14100724	0	0	0	0	0
3L	14111714	0	0	0	0	0
3L	14112636	0	2	0	10	12
3L	14212209	0	0	60	0	60
3L	14227988	1	0	0	0	1
3L	14235297	0	0	0	2	2
3L	14236740	9	0	0	0	9
3L	14368016	4	0	9	0	13
3L	14426456	0	0	0	1	1
3L	14439493	0	0	0	0	0
3L	14755055	0	0	0	0	0
3L	14764947	51	0	21	0	72
3L	14799253	36	0	6	0	42
3L	14862538	0	0	0	0	0
3L	14882352	0	0	0	0	0
3L	15043222	0	0	0	0	0
3L	15102878	0	0	0	0	0
3L	15102879	0	0	0	0	0
3L	15102886	0	0	0	0	0
3L	15102895	0	0	0	0	0
3L	15102896	0	0	0	0	0
3L	15102897	0	0	0	0	0
3L	15102934	0	0	0	0	0
3L	15102939	0	0	0	0	0
3L	15472441	0	0	0	0	0
3L	15517405	0	0	0	0	0
3L	15532890	0	0	0	0	0
3L	15555171	2	0	0	0	2
3L	15658259	0	0	0	0	0
3L	15658274	0	0	0	0	0
3L	15659522	0	0	0	0	0
3L	15757800	0	0	0	0	0
3L	15893762	0	20	0	25	45
3L	15895755	0	0	0	1	1
3L	16052231	2	0	4	0	6
3L	16111589	0	30	0	91	121
3L	16181016	0	0	0	0	0
3L	16181038	0	0	0	0	0
3L	16181052	0	0	0	0	0
3L	16181053	0	0	0	0	0
3L	16181094	0	0	0	0	0
3L	16182056	0	0	0	0	0
3L	16182169	0	0	0	0	0
3L	16182170	0	0	0	0	0
3L	16186140	0	0	0	0	0
3L	16186145	0	0	0	0	0
3L	16186363	0	0	0	0	0
3L	16254434	0	0	0	0	0
3L	16254435	0	0	0	0	0
3L	16255064	1	0	0	0	1
3L	16255072	0	0	1	0	1
3L	16262552	0	0	0	0	0
3L	16270810	0	0	0	0	0
3L	16291947	0	0	0	0	0
3L	16577155	0	0	0	0	0
3L	16616020	19	0	0	0	19
3L	16616021	0	0	0	19	19
3L	16617760	0	0	0	0	0
3L	16642757	0	0	0	0	0
3L	16645041	0	0	0	0	0
3L	16674672	0	0	0	0	0
3L	16678530	0	1	0	117	118
3L	16686521	0	0	0	0	0
3L	16688610	0	0	0	0	0
3L	16692734	0	0	0	0	0
3L	16728214	0	0	0	0	0
3L	16731471	0	0	0	0	0
3L	16736878	0	0	0	0	0
3L	16758529	0	0	0	0	0
3L	16786895	127	0	0	0	127
3L	16786980	0	0	0	1	1
3L	16908885	1	0	0	0	1
3L	16910270	0	0	2	0	2
3L	16968101	0	0	0	310	310
3L	17075627	0	4	0	0	4
3L	17378242	0	0	0	0	0
3L	17389187	0	0	0	0	0
3L	17425746	0	0	4	0	4
3L	17451133	15	0	0	0	15
3L	17475161	2	0	0	0	2
3L	17597746	0	14	0	6	20
3L	17668401	0	0	0	18	18
3L	17689993	0	0	0	1	1
3L	17726464	0	0	0	0	0
3L	17742206	0	0	0	10	10
3L	17951569	110	0	0	0	110
3L	17979662	0	0	0	0	0
3L	17979744	0	0	0	0	0
3L	18027635	0	0	0	0	0
3L	18087658	0	0	0	0	0
3L	18090225	1	0	0	0	1
3L	18132571	0	0	0	0	0
3L	18181206	0	0	0	0	0
3L	18189120	0	0	0	0	0
3L	18281392	0	0	0	0	0
3L	18281522	0	0	0	0	0
3L	18555038	0	0	0	0	0
3L	18596316	0	0	0	0	0
3L	18670895	0	0	0	90	90
3L	18682575	19	0	0	0	19
3L	18685220	0	3	0	11	14
3L	18685424	0	5	0	9	14
3L	18728861	0	0	0	0	0
3L	18800841	28	0	0	0	28
3L	18819562	0	0	0	10	10
3L	18878588	0	0	0	122	122
3L	18878936	0	0	0	280	280
3L	18897569	0	0	0	4	4
3L	18922609	0	0	0	3	3
3L	18922733	0	0	0	8	8
3L	19052915	0	0	0	0	0
3L	19055200	0	0	0	0	0
3L	19066432	0	0	0	12	12
3L	19067899	0	0	0	29	29
3L	19070611	0	1	0	0	1
3L	19106047	0	5	0	12	17
3L	19110288	0	22	0	7	29
3L	19147008	0	0	0	0	0
3L	19160049	0	0	0	0	0
3L	19283200	0	13	0	102	115
3L	19283264	0	56	0	60	116
3L	19283265	0	8	0	110	118
3L	19341568	0	0	0	29	29
3L	19369627	1	0	0	0	1
3L	19371398	0	0	0	0	0
3L	19399656	0	0	0	0	0
3L	19411978	0	0	0	0	0
3L	19501470	0	0	0	0	0
3L	19513044	1	0	0	0	1
3L	19516477	0	0	0	0	0
3L	19531391	0	0	0	0	0
3L	19542365	0	0	0	50	50
3L	19545728	0	1	8	0	9
3L	19578009	0	1	0	0	1
3L	19618855	0	0	0	0	0
3L	19689767	1021	0	175	0	1196
3L	19689870	113	0	613	0	726
3L	19689871	19	0	693	1	713
3L	19932956	0	0	0	0	0
3L	20035022	0	1	0	0	1
3L	20098494	0	0	0	124	124
3L	20156776	0	8	0	6	14
3L	20156958	0	17	0	22	39
3L	20252103	1	0	6	0	7
3L	20353020	0	0	0	24	24
3L	20379678	54	0	16	0	70
3L	20391933	0	0	0	13	13
3L	20420837	0	7	0	0	7
3L	20427294	0	16	0	10	26
3L	20428234	0	5	0	5	10
3L	20453518	0	0	0	1	1
3L	20465542	0	0	0	0	0
3L	20502571	0	0	0	0	0
3L	20502628	0	0	0	0	0
3L	20503418	2	0	0	0	2
3L	20523500	0	30	0	45	75
3L	20598406	0	8	0	4	12
3L	20598874	0	0	0	13	13
3L	20690411	0	0	0	0	0
3L	20768391	0	0	0	16	16
3L	20773150	50	0	139	0	189
3L	20773190	53	0	120	0	173
3L	20773546	158	0	7	0	165
3L	20773569	127	0	49	0	176
3L	20773589	147	0	27	0	174
3L	20773609	148	0	46	0	194
3L	20773610	141	0	53	0	194
3L	20802315	1	0	0	0	1
3L	20817830	0	0	0	2	2
3L	20820474	39	0	0	0	39
3L	20867520	0	0	0	2	2
3L	20879740	0	0	0	0	0
3L	20885034	0	27	0	61	88
3L	20942629	0	0	0	0	0
3L	20975576	0	0	0	0	0
3L	21072555	182	0	0	0	182
3L	21115651	0	0	0	0	0
3L	21118999	0	0	0	0	0
3L	21130550	0	0	0	0	0
3L	21130556	0	0	0	0	0
3L	21130559	0	0	0	0	0
3L	21130564	0	0	0	0	0
3L	21130610	0	0	0	0	0
3L	21130611	0	0	0	0	0
3L	21130618	0	0	0	0	0
3L	21130621	0	0	0	0	0
3L	21164936	0	0	0	0	0
3L	21179937	0	68	0	0	68
3L	21195648	0	0	0	9	9
3L	21203253	27	0	3	0	30
3L	21204995	1	0	0	0	1
3L	21205002	1	0	0	0	1
3L	21207897	48	0	3	0	51
3L	21210325	21	0	40	0	61
3L	21213292	42	0	37	0	79
3L	21226173	0	0	0	0	0
3L	21309631	0	0	0	0	0
3L	21333937	13	0	33	0	46
3L	21390253	0	0	0	0	0
3L	21390256	0	0	0	0	0
3L	21390260	0	0	0	0	0
3L	21390271	0	0	0	0	0
3L	21390275	0	0	0	0	0
3L	21390282	0	0	0	0	0
3L	21390294	0	0	0	0	0
3L	21390295	0	0	0	0	0
3L	21390303	0	0	0	0	0
3L	21390314	0	0	0	0	0
3L	21391007	0	0	0	0	0
3L	21391234	0	0	0	0	0
3L	21391240	0	0	0	0	0
3L	21644394	0	0	0	0	0
3L	21644396	0	0	0	0	0
3L	21644402	0	0	0	0	0
3L	21696292	0	0	0	0	0
3L	21696294	0	0	0	0	0
3L	21696345	0	0	0	0	0
3L	21696349	0	0	0	0	0
3L	21696352	0	0	0	0	0
3L	21696354	0	0	0	0	0
3L	21696356	0	0	0	0	0
3L	21696357	0	0	0	0	0
3L	21696361	0	0	0	0	0
3L	21696364	0	0	0	0	0
3L	21696375	0	0	0	0	0
3L	21696397	0	0	0	0	0
3L	21696400	0	0	0	0	0
3L	21696404	0	0	0	0	0
3L	21696405	0	0	0	0	0
3L	21696410	0	0	0	0	0
3L	21714311	0	0	0	0	0
3L	21715425	0	0	0	0	0
3L	21717050	0	1	0	0	1
3L	21728957	6	0	0	0	6
3L	21845812	0	0	0	0	0
3L	22132252	2	0	0	0	2
3L	22133068	1	0	0	0	1
3L	22133070	0	0	0	1	1
3L	22169386	0	0	0	0	0
3L	22268084	5	0	4	0	9
3L	22273143	365	0	30	0	395
3L	22273144	384	0	11	0	395
3L	22463672	0	0	0	2	2
3L	22655901	0	0	0	0	0
3L	22731262	3	0	0	0	3
3L	22793765	0	0	0	18	18
3L	22826560	0	0	0	0	0
3L	22827988	0	0	0	0	0
3L	22894950	0	0	0	0	0
3L	22894959	0	0	0	0	0
3L	23022502	18	0	3	0	21
3L	23022517	9	0	12	0	21
3L	23022531	16	0	2	0	18
3L	23022558	15	0	7	0	22
3L	23022565	13	0	10	0	23
3L	23022570	3	0	22	0	25
3L	23022589	4	0	20	0	24
3L	23022624	15	0	4	0	19
3L	23022651	18	1	2	0	21
3L	23022665	18	0	3	0	21
3L	23022696	18	0	3	0	21
3L	23022733	16	0	6	0	22
3L	23022747	13	0	5	0	18
3L	23022860	12	0	0	0	12
3L	23022915	11	0	5	0	16
3L	23023572	18	0	6	0	24
3L	23023737	15	0	7	0	22
3L	23023745	19	0	2	0	21
3L	23023746	21	0	1	0	22
3L	23023752	4	0	16	0	20
3L	23023759	8	0	12	0	20
3L	23023768	3	0	16	0	19
3L	23023772	4	0	17	0	21
3L	23023773	8	0	13	0	21
3L	23023776	10	0	10	0	20
3L	23023778	9	0	10	0	19
3L	23034648	11	0	99	0	110
3L	23035386	96	0	6	0	102
3L	23035498	67	0	15	1	83
3L	23035510	52	0	24	0	76
3L	23036047	86	0	13	0	99
3L	23036053	33	0	64	0	97
3L	23036055	86	0	12	0	98
3L	23036058	4	0	97	0	101
3L	23036059	50	0	52	0	102
3L	23036066	21	0	81	0	102
3L	23036068	65	0	41	0	106
3L	23036071	4	0	108	0	112
3L	23036082	95	0	20	0	115
3L	23036083	106	0	8	0	114
3L	23036084	105	0	11	0	116
3L	23036087	103	0	13	0	116
3L	23036098	92	0	18	0	110
3L	23036101	99	0	15	0	114
3L	23036116	72	0	47	0	119
3L	23036121	90	0	27	0	117
3L	23036453	71	0	23	0	94
3L	23036548	28	0	38	0	66
3L	23036588	37	0	26	0	63
3L	23036631	33	0	35	0	68
3L	23216253	0	0	0	0	0
3L	23228909	2	0	0	0	2
3L	23228910	1	0	1	0	2
3L	23228912	2	0	0	0	2
3L	23228932	2	0	0	0	2
3L	23231321	1	0	0	0	1
3L	23232223	0	0	0	0	0
3L	23241819	0	0	0	0	0
3L	23252714	0	0	0	0	0
3L	23284872	25	0	2	0	27
3L	23286473	83	0	13	0	96
3L	23286550	92	1	20	0	113
3L	23579149	0	0	0	0	0
3L	23742459	6	0	10	0	16
3L	23743265	14	0	3	0	17
3L	23743306	11	0	1	0	12
3L	23796662	0	0	0	0	0
3L	24031604	16	0	11	0	27
3L	24031889	10	0	10	0	20
3L	24031891	11	0	9	0	20
3L	24040526	0	0	0	0	0
3L	24074572	2	0	0	0	2
3L	24074586	2	0	0	0	2
3L	24074603	0	0	2	0	2
3L	24074606	0	0	2	0	2
3L	24074610	0	0	2	0	2
3L	24074617	0	0	2	0	2
3L	24074621	2	0	0	0	2
3L	24074625	0	0	2	0	2
3L	24074665	0	0	3	0	3
3L	24074669	0	0	3	0	3
3L	24074673	0	0	3	0	3
3L	24074677	0	0	2	0	2
3L	24074679	2	0	0	0	2
3L	24074680	0	0	2	0	2
3L	24074682	1	0	1	0	2
3L	24074685	0	0	2	0	2
3L	24074697	0	0	2	0	2
3L	24074700	1	0	1	0	2
3L	24074710	1	0	1	0	2
3L	24074713	1	0	1	0	2
3L	24074747	0	0	0	0	0
3L	24074754	0	0	0	0	0
3L	24074759	0	0	0	0	0
3L	24074986	0	0	1	0	1
3L	24184343	0	0	0	0	0
3L	24184352	0	0	0	0	0
3L	24260884	0	0	0	0	0
3L	24539756	1	0	1	0	2
3L	24574446	0	0	0	0	0
3L	24727794	0	0	0	0	0
3L	24729192	0	0	0	0	0
3L	24729203	0	0	0	0	0
3L	24729209	0	0	0	0	0
3L	24729558	0	0	0	0	0
3L	24734394	1	0	0	0	1
3L	24734409	1	0	0	0	1
3L	24734433	0	0	0	0	0
3L	24734434	0	0	0	0	0
3L	24734444	0	0	0	0	0
3L	24734445	0	0	0	0	0
3L	24734544	1	0	0	0	1
3L	24734545	1	0	0	0	1
3L	24734548	1	0	0	0	1
3L	24734549	1	0	0	0	1
3L	24734550	1	0	0	0	1
3L	24734565	1	0	0	0	1
3L	24734583	0	0	1	0	1
3L	24739737	0	0	1	0	1
3L	24739770	1	0	1	0	2
3L	24739940	1	0	0	0	1
3L	24739953	0	0	1	0	1
3L	25191188	0	0	0	0	0
3L	25404612	0	0	0	3	3
3L	25411101	0	0	0	0	0
3L	25440130	0	0	0	0	0
3L	25487370	0	0	0	0	0
3L	25519478	0	0	0	1	1
3L	25519484	0	0	0	1	1
3L	25519485	0	0	0	1	1
3L	25519514	0	0	0	1	1
3L	25519515	0	0	0	1	1
3L	25519516	0	0	0	1	1
3L	25519519	0	0	0	1	1
3L	25519523	0	0	0	1	1
3L	25519524	0	0	0	1	1
3L	25598311	0	0	0	0	0
3L	25608424	0	0	0	0	0
3L	25608425	0	0	0	0	0
3L	25608436	0	0	0	0	0
3L	25633906	0	1	0	1	2
3L	25633926	0	1	0	1	2
3L	25668383	0	0	0	0	0
3L	25668389	0	0	0	0	0
3L	25668390	0	0	0	0	0
3L	25668438	0	0	0	0	0
3L	25668442	0	0	0	0	0
3L	25668450	0	0	0	0	0
3L	25668451	0	0	0	0	0
3L	25668452	0	0	0	0	0
3L	25668462	0	0	0	0	0
3L	25668464	0	0	0	0	0
3L	25668466	0	0	0	0	0
3L	25668467	0	0	0	0	0
3L	25668501	0	0	0	0	0
3L	25668503	0	0	0	0	0
3L	25668653	0	0	0	0	0
3L	25669834	0	0	0	0	0
3L	25669886	0	0	0	1	1
3L	25669903	0	0	0	0	0
3L	25669904	0	0	0	0	0
3L	25669929	0	0	0	0	0
3L	25669935	0	0	0	0	0
3L	25674685	0	0	1	0	1
3L	25674703	1	0	1	0	2
3L	25674878	3	0	1	0	4
3L	25849333	0	0	0	0	0
3L	25873801	0	0	0	0	0
3L	25920861	0	0	0	0	0
3L	26001042	0	0	0	2	2
3L	26002127	0	0	0	6	6
3L	26002138	0	0	0	6	6
3L	26002140	0	0	0	6	6
3L	26002728	0	1	0	2	3
3L	26003264	0	2	0	3	5
3L	26009778	0	3	0	0	3
3L	26009830	0	3	0	0	3
3L	26012760	0	0	0	2	2
3L	26012768	0	0	0	3	3
3L	26582674	0	0	0	0	0
3L	26594673	0	0	0	0	0
3L	26610401	0	0	0	0	0
3L	26666453	0	0	0	0	0
3L	26667951	1	0	0	0	1
3L	26756592	0	0	0	0	0
3L	27281127	2	0	1	0	3
3L	27281185	2	0	1	0	3
3L	27845559	0	0	0	0	0
3L	27845560	0	0	0	0	0
3L	27845708	0	0	0	0	0
3L	28002470	0	0	0	0	0
3L	28002543	0	0	0	0	0
3L	28002555	0	0	0	0	0
3L	28002560	0	0	0	0	0
3L	28002748	0	0	0	0	0
3L	28002752	0	0	0	0	0
3R	2156963	0	0	0	0	0
3R	3122736	0	0	0	0	0
3R	3122737	0	0	0	0	0
3R	3751950	2	0	1	0	3
3R	4131662	1	0	0	0	1
3R	4185912	12	0	7	0	19
3R	4185926	11	0	9	0	20
3R	4185927	10	0	11	0	21
3R	4185928	15	0	7	0	22
3R	4186013	26	0	4	0	30
3R	4186020	25	0	2	0	27
3R	4186021	24	0	3	0	27
3R	4186029	25	0	2	0	27
3R	4186038	22	0	4	0	26
3R	4186053	23	0	7	0	30
3R	4186057	29	0	3	0	32
3R	4186060	30	0	2	0	32
3R	4186071	27	0	2	0	29
3R	4186077	31	0	0	0	31
3R	4186090	29	0	3	0	32
3R	4186091	22	0	9	0	31
3R	4279033	0	23	0	12	35
3R	4279036	0	23	0	15	38
3R	4279126	0	31	0	9	40
3R	4279127	0	32	0	8	40
3R	4279128	0	22	0	17	39
3R	4297057	102	0	28	0	130
3R	4297067	130	0	9	0	139
3R	4297086	128	0	2	0	130
3R	4297093	134	0	7	0	141
3R	4297095	124	0	18	0	142
3R	4297504	932	1	687	1	1621
3R	4297517	1245	0	308	0	1553
3R	4297518	1056	0	515	0	1571
3R	4299218	191	0	24	0	215
3R	4299387	188	0	13	0	201
3R	4299391	137	0	57	0	194
3R	4301117	95	0	12	0	107
3R	4301124	110	0	4	0	114
3R	4301140	76	0	20	0	96
3R	4301142	83	0	15	0	98
3R	4301144	91	0	7	0	98
3R	4301150	58	0	41	0	99
3R	4301158	96	0	14	0	110
3R	4301166	104	0	13	0	117
3R	4301174	106	0	11	0	117
3R	4301182	119	0	10	0	129
3R	4301190	101	0	27	0	128
3R	4301192	117	0	9	1	127
3R	4301196	117	0	12	0	129
3R	4301198	105	0	23	0	128
3R	4301200	103	0	30	0	133
3R	4301206	101	0	30	0	131
3R	4301208	116	0	22	1	139
3R	4301212	111	0	28	0	139
3R	4301214	124	0	19	0	143
3R	4301216	125	0	14	1	140
3R	4301240	92	0	46	0	138
3R	4301244	94	0	40	0	134
3R	4301246	99	0	36	0	135
3R	4301248	118	0	18	0	136
3R	4301250	112	0	24	0	136
3R	4301252	140	0	10	0	150
3R	4301254	132	0	28	0	160
3R	4301258	120	0	45	0	165
3R	4365384	118	0	118	0	236
3R	4365385	9	0	225	0	234
3R	4365474	111	0	141	0	252
3R	4493894	0	14	0	4	18
3R	4656505	54	0	15	0	69
3R	4702574	26	0	14	0	40
3R	4944773	2	0	0	0	2
3R	4965472	71	0	0	0	71
3R	5084900	0	0	0	104	104
3R	5236209	0	57	0	386	443
3R	5236328	0	67	0	834	901
3R	5236329	0	278	0	642	920
3R	5236332	0	877	0	40	917
3R	5236375	1	604	0	372	977
3R	5236378	0	497	1	491	989
3R	5260897	0	0	0	0	0
3R	5260900	0	0	0	0	0
3R	5260901	0	0	0	0	0
3R	5260908	0	0	0	0	0
3R	5260909	0	0	0	0	0
3R	5260910	0	0	0	0	0
3R	5260911	0	0	0	0	0
3R	5260913	0	0	0	0	0
3R	5260914	0	0	0	0	0
3R	5260918	0	0	0	0	0
3R	5260923	0	0	0	0	0
3R	5260926	0	0	0	0	0
3R	5260929	0	0	0	0	0
3R	5260930	0	0	0	0	0
3R	5260931	0	0	0	0	0
3R	5260932	0	0	0	0	0
3R	5260940	0	0	0	0	0
3R	5260941	0	0	0	0	0
3R	5260944	0	0	0	0	0
3R	5260945	0	0	0	0	0
3R	5260946	0	0	0	0	0
3R	5260947	0	0	0	0	0
3R	5260948	0	0	0	0	0
3R	5260949	0	0	0	0	0
3R	5260954	0	0	0	0	0
3R	5260956	0	0	0	0	0
3R	5260957	0	0	0	0	0
3R	5260958	0	0	0	0	0
3R	5260960	0	0	0	0	0
3R	5260961	0	0	0	0	0
3R	5260962	0	0	0	0	0
3R	5260963	0	0	0	0	0
3R	5260964	0	0	0	0	0
3R	5260965	0	0	0	0	0
3R	5260968	0	0	0	0	0
3R	5260969	0	0	0	0	0
3R	5260970	0	0	0	0	0
3R	5260971	0	0	0	0	0
3R	5260972	0	0	0	0	0
3R	5260973	0	0	0	0	0
3R	5260974	0	0	0	0	0
3R	5260976	0	0	0	0	0
3R	5260981	0	0	0	0	0
3R	5260982	0	0	0	0	0
3R	5260984	0	0	0	0	0
3R	5260985	0	0	0	0	0
3R	5260986	0	0	0	0	0
3R	5260987	0	0	0	0	0
3R	5260992	0	0	0	0	0
3R	5260993	0	0	0	0	0
3R	5260994	0	0	0	0	0
3R	5260995	0	0	0	0	0
3R	5260998	0	0	0	0	0
3R	5261005	0	0	0	0	0
3R	5261038	0	0	0	0	0
3R	5261039	0	0	0	0	0
3R	5261045	0	0	0	0	0
3R	5261046	0	0	0	0	0
3R	5261050	0	0	0	0	0
3R	5261052	0	0	0	0	0
3R	5261064	0	0	0	0	0
3R	5261070	0	0	0	0	0
3R	5261071	0	0	0	0	0
3R	5261073	0	0	0	0	0
3R	5268529	5	0	11	0	16
3R	5331180	0	0	0	0	0
3R	5456078	7	0	61	0	68
3R	5510248	0	6	0	50	56
3R	5512061	0	12	0	46	58
3R	5512062	0	10	0	50	60
3R	5579358	18	0	0	0	18
3R	5650231	57	0	49	0	106
3R	5650351	70	0	59	0	129
3R	5686487	11	0	0	0	11
3R	5794759	16	0	0	0	16
3R	5813914	0	0	0	17	17
3R	5835138	6	0	0	0	6
3R	6004380	0	229	0	368	597
3R	6198321	0	0	0	0	0
3R	6410404	0	0	0	0	0
3R	6454240	0	0	0	25	25
3R	6455990	0	7	0	19	26
3R	6456079	0	0	0	25	25
3R	6481790	0	0	0	2	2
3R	6482470	7	0	0	0	7
3R	6483189	1	0	3	0	4
3R	6646984	32	0	0	0	32
3R	6656412	0	0	0	35	35
3R	6825353	0	7	0	10	17
3R	7192775	24	0	259	0	283
3R	7192825	225	0	50	0	275
3R	7472957	0	1	0	5	6
3R	7474763	0	26	0	41	67
3R	7523172	0	0	0	0	0
3R	7527658	0	0	0	0	0
3R	7541970	2	0	1	0	3
3R	7541971	3	0	0	0	3
3R	7578932	0	2	0	0	2
3R	7632065	0	0	0	1	1
3R	7633948	0	0	0	0	0
3R	7857376	0	3	0	116	119
3R	7860890	0	2	0	17	19
3R	7886440	0	27	0	50	77
3R	7959962	0	0	0	0	0
3R	7975631	0	0	0	263	263
3R	8023269	0	31	0	88	119
3R	8025032	0	116	0	0	116
3R	8237633	0	0	0	18	18
3R	8380051	0	15	0	24	39
3R	8380439	0	19	0	19	38
3R	8380442	0	13	0	25	38
3R	8385971	0	0	0	46	46
3R	8386738	0	9	0	24	33
3R	8386758	0	4	0	23	27
3R	8658956	0	0	0	0	0
3R	8659112	0	0	0	0	0
3R	8661419	0	98	0	0	98
3R	8678362	0	0	23	0	23
3R	8736376	0	3	0	33	36
3R	8737810	0	16	0	25	41
3R	8775615	0	574	0	0	574
3R	8788015	0	0	0	0	0
3R	8788344	0	0	0	0	0
3R	8791608	0	0	0	0	0
3R	8795508	0	2	0	0	2
3R	8812828	0	14	0	0	14
3R	8834533	0	164	0	0	164
3R	8836915	0	60	0	23	83
3R	8836926	0	64	0	28	92
3R	8836929	0	49	0	44	93
3R	8837184	0	89	0	23	112
3R	8837191	0	82	0	31	113
3R	8837610	0	70	0	39	109
3R	8851870	0	2	0	0	2
3R	8864798	0	0	0	41	41
3R	8864972	0	0	0	53	53
3R	8867172	0	0	0	1	1
3R	8922284	0	0	0	1	1
3R	8937081	0	0	0	0	0
3R	8952096	0	0	0	0	0
3R	8992964	0	0	0	0	0
3R	9092757	0	5	0	0	5
3R	9094689	0	2	0	0	2
3R	9120444	0	7	0	0	7
3R	9134740	0	1	0	0	1
3R	9147309	0	0	0	0	0
3R	9192083	0	0	0	1	1
3R	9192878	0	0	0	0	0
3R	9195940	0	4	0	0	4
3R	9350774	1	0	0	0	1
3R	9354339	0	0	0	0	0
3R	9385249	0	1	0	0	1
3R	9394121	0	2	0	12	14
3R	9418495	25	0	0	0	25
3R	9418834	26	0	4	0	30
3R	9419410	14	0	16	0	30
3R	9419457	11	0	8	0	19
3R	9421085	5	0	0	0	5
3R	9428183	7	0	0	0	7
3R	9428227	7	0	2	0	9
3R	9428853	2	0	6	0	8
3R	9430861	5	0	1	0	6
3R	9430877	6	0	0	0	6
3R	9448522	252	0	51	0	303
3R	9451570	245	0	0	0	245
3R	9451939	199	0	100	0	299
3R	9455622	0	0	0	9	9
3R	9465643	0	0	0	67	67
3R	9492559	0	0	0	3	3
3R	9525980	0	0	86	0	86
3R	9544703	0	0	0	12	12
3R	9544820	0	1	0	7	8
3R	9591515	40	0	0	0	40
3R	9591859	26	0	0	0	26
3R	9614889	1	0	0	0	1
3R	9666847	0	0	0	0	0
3R	9721112	0	71	0	0	71
3R	9727213	0	67	0	0	67
3R	9729053	0	0	0	103	103
3R	9754511	0	13	0	0	13
3R	9761125	34	0	0	0	34
3R	9769425	87	0	75	0	162
3R	9798395	0	0	0	73	73
3R	9965066	0	0	0	0	0
3R	10029831	0	0	0	0	0
3R	10083460	1	0	0	0	1
3R	10097183	1	0	0	0	1
3R	10194903	31	0	9	0	40
3R	10194972	25	0	12	0	37
3R	10194990	23	0	10	0	33
3R	10195423	248	1	50	1	300
3R	10195426	9	1	285	0	295
3R	10195571	56	0	0	0	56
3R	10195983	151	0	83	0	234
3R	10195984	99	0	136	0	235
3R	10227022	3	0	7	0	10
3R	10228870	101	0	0	0	101
3R	10245424	131	0	26	0	157
3R	10245425	44	0	113	0	157
3R	10305770	33	0	0	0	33
3R	10333913	13	0	0	0	13
3R	10372369	0	0	0	16	16
3R	10391255	3	0	0	0	3
3R	10392923	7	0	0	0	7
3R	10393067	8	0	0	0	8
3R	10394318	10	0	0	0	10
3R	10515812	0	0	0	1	1
3R	10558186	0	0	0	2	2
3R	10584920	0	53	0	70	123
3R	10585180	0	16	0	28	44
3R	10585186	0	15	0	27	42
3R	10766619	0	0	30	0	30
3R	10768515	0	16	0	104	120
3R	10776609	0	0	0	4	4
3R	10782974	0	39	0	0	39
3R	10871792	0	0	0	241	241
3R	11127820	0	0	0	17	17
3R	11193273	0	0	0	0	0
3R	11398476	53	0	75	0	128
3R	11398478	102	0	27	0	129
3R	11450201	0	2	0	0	2
3R	11589338	0	0	0	47	47
3R	11765112	0	9	0	37	46
3R	11801192	0	67	0	54	121
3R	11951530	104	0	43	0	147
3R	11951562	36	0	102	0	138
3R	11953544	3	0	217	1	221
3R	11985293	0	479	0	1	480
3R	11989608	0	14	0	0	14
3R	11994674	0	109	0	0	109
3R	12079394	0	9	0	14	23
3R	12079473	0	6	0	20	26
3R	12096226	24	0	0	0	24
3R	12163774	0	0	0	785	785
3R	12164347	0	107	0	655	762
3R	12215148	9	0	0	0	9
3R	12283052	0	0	0	0	0
3R	12411087	95	0	0	0	95
3R	12416318	44	1	0	0	45
3R	12516932	0	15	0	11	26
3R	12593574	0	1	0	12	13
3R	12593953	0	3	0	23	26
3R	12594802	0	0	0	17	17
3R	12705537	0	0	0	0	0
3R	12741372	0	0	0	0	0
3R	13004750	1	0	85	0	86
3R	13004828	0	0	104	0	104
3R	13018291	6	0	0	0	6
3R	13373289	0	0	1	569	570
3R	13382634	2	0	0	0	2
3R	13399579	0	186	0	0	186
3R	13462029	0	0	66	0	66
3R	13528966	0	0	0	0	0
3R	13663586	0	0	259	0	259
3R	13692592	50	0	27	0	77
3R	13692593	71	0	10	0	81
3R	13725311	0	0	0	0	0
3R	13782016	0	0	6	0	6
3R	13782327	0	0	0	0	0
3R	13959841	0	0	508	0	508
3R	13993445	0	0	0	7	7
3R	14105598	0	16	0	0	16
3R	14108210	0	14	0	0	14
3R	14128425	0	0	42	0	42
3R	14330746	0	0	0	60	60
3R	14363401	0	0	0	0	0
3R	14363405	0	0	0	0	0
3R	14395408	0	0	0	60	60
3R	14409075	0	0	0	63	63
3R	14515193	0	1	0	77	78
3R	14522391	1	0	644	0	645
3R	14623285	0	0	0	67	67
3R	14735962	0	1	0	0	1
3R	14746231	0	0	0	49	49
3R	14746547	0	0	0	88	88
3R	14747108	0	0	0	83	83
3R	14788816	0	0	66	0	66
3R	14809014	0	0	0	1	1
3R	14880381	13	0	0	0	13
3R	14891090	0	0	1172	0	1172
3R	14903154	0	7	0	0	7
3R	14919312	33	0	0	0	33
3R	14996135	0	0	0	0	0
3R	15097165	0	9	0	56	65
3R	15099803	0	0	0	75	75
3R	15287927	1	0	2	0	3
3R	15288163	11	0	1	0	12
3R	15294740	10	0	0	0	10
3R	15296683	818	0	9	0	827
3R	15296695	830	0	4	0	834
3R	15297732	3	0	0	0	3
3R	15298760	5	0	0	0	5
3R	15306860	20	0	0	0	20
3R	15306861	19	0	1	0	20
3R	15384375	11	0	0	0	11
3R	15387222	98	0	84	0	182
3R	15388396	76	0	103	0	179
3R	15392578	149	0	0	0	149
3R	15399446	69	1	134	0	204
3R	15400137	25	0	0	0	25
3R	15400209	16	0	2	0	18
3R	15400211	17	0	2	0	19
3R	15400224	0	0	12	0	12
3R	15401498	0	0	0	154	154
3R	15413254	89	0	153	1	243
3R	15413305	92	0	165	0	257
3R	15413827	0	0	118	0	118
3R	15822468	101	0	27	0	128
3R	15950619	0	0	0	2	2
3R	16003657	9	0	26	0	35
3R	16045954	0	2	0	4	6
3R	16065967	0	1	0	1	2
3R	16087664	0	0	0	0	0
3R	16096668	0	77	0	42	119
3R	16097238	0	39	0	62	101
3R	16302773	28	0	25	0	53
3R	16302775	28	0	25	0	53
3R	16303403	68	0	12	0	80
3R	16303415	54	0	21	0	75
3R	16502786	13	0	0	0	13
3R	16591505	0	0	0	1	1
3R	16633290	101	0	15	0	116
3R	16633369	36	0	33	1	70
3R	16809936	0	0	0	0	0
3R	16827828	0	0	0	0	0
3R	17140246	0	0	0	0	0
3R	17149369	0	0	0	13	13
3R	17502097	0	0	0	0	0
3R	17544578	97	0	44	0	141
3R	17544743	82	0	20	0	102
3R	17750942	0	0	0	9	9
3R	17750957	0	7	0	4	11
3R	17770919	0	52	0	0	52
3R	17771810	0	66	0	0	66
3R	17772922	0	74	0	0	74
3R	17773982	0	12	0	6	18
3R	17774217	0	36	0	19	55
3R	17774401	0	0	26	0	26
3R	17774920	0	3	0	3	6
3R	17775731	0	14	0	0	14
3R	17778660	0	21	0	0	21
3R	17795473	0	0	24	0	24
3R	17796092	0	0	18	0	18
3R	17796780	0	48	0	0	48
3R	17797297	0	54	0	0	54
3R	17799317	0	5	0	0	5
3R	17808359	0	24	0	0	24
3R	17809478	0	9	0	0	9
3R	17852526	0	0	53	0	53
3R	17865673	0	0	72	0	72
3R	17873639	0	96	0	119	215
3R	17874391	0	204	0	0	204
3R	17877415	0	219	0	0	219
3R	17881420	0	116	0	72	188
3R	17881807	0	0	0	213	213
3R	17882765	0	69	0	6	75
3R	17897257	0	6	0	11	17
3R	17905164	0	0	0	72	72
3R	17905999	0	0	0	111	111
3R	17908804	50	0	0	0	50
3R	17938630	0	0	0	0	0
3R	17944246	0	0	0	0	0
3R	17945071	0	0	7	0	7
3R	17945344	0	0	3	0	3
3R	17945752	0	0	5	0	5
3R	17946291	0	0	8	0	8
3R	17947397	43	0	0	0	43
3R	17949372	0	0	0	0	0
3R	17967291	0	0	148	0	148
3R	17967728	145	0	15	0	160
3R	17976866	0	0	1	0	1
3R	17980448	2	0	3	0	5
3R	17986938	4	0	0	0	4
3R	17992257	2	0	0	0	2
3R	17994037	7	0	0	0	7
3R	17994206	3	0	0	0	3
3R	18017356	76	0	0	0	76
3R	18133238	15	0	0	0	15
3R	18199189	0	0	0	14	14
3R	18205263	1	0	0	0	1
3R	18226004	0	0	0	10	10
3R	18236442	58	1	0	0	59
3R	18238159	103	0	0	0	103
3R	18290939	0	22	0	69	91
3R	18355194	0	30	0	3	33
3R	18355198	0	24	0	9	33
3R	18355305	0	16	0	15	31
3R	18360355	0	3	0	6	9
3R	18498021	0	0	0	0	0
3R	18599594	0	1	0	0	1
3R	18674009	12	0	0	0	12
3R	18801700	0	11	0	40	51
3R	18806029	0	8	0	33	41
3R	18824181	0	0	0	0	0
3R	18881308	0	0	0	0	0
3R	18907574	438	1	50	0	489
3R	18907652	127	0	368	0	495
3R	18907675	116	0	345	0	461
3R	18907799	181	0	122	0	303
3R	18907980	352	1	122	0	475
3R	18910005	174	0	8	0	182
3R	18910153	24	0	198	0	222
3R	18970679	302	0	13	0	315
3R	18970692	247	0	51	0	298
3R	18971312	229	0	115	0	344
3R	19081553	0	0	0	0	0
3R	19140149	0	26	0	66	92
3R	19141001	0	28	0	85	113
3R	19218093	0	0	0	0	0
3R	19231096	0	53	0	269	322
3R	19231097	0	122	0	202	324
3R	19231100	0	22	0	308	330
3R	19238197	0	128	0	165	293
3R	19238358	0	98	0	171	269
3R	19238845	0	74	0	131	205
3R	19389278	0	0	0	0	0
3R	19579291	0	0	1	0	1
3R	19637450	0	0	0	36	36
3R	19643921	0	31	0	0	31
3R	19653645	0	51	0	37	88
3R	19660641	0	0	1	0	1
3R	19662383	16	0	22	0	38
3R	19662407	0	0	42	0	42
3R	19734535	1	0	0	0	1
3R	19753763	36	0	93	0	129
3R	19753764	16	0	111	0	127
3R	19763634	32	0	164	1	197
3R	19765660	86	0	32	1	119
3R	19766576	0	0	126	0	126
3R	19836444	0	0	0	0	0
3R	19840656	0	0	0	0	0
3R	19847652	7	0	0	0	7
3R	19848089	4	0	3	0	7
3R	19848545	7	0	0	0	7
3R	19850222	48	0	70	0	118
3R	19901320	0	159	0	0	159
3R	19901682	0	0	0	128	128
3R	19914707	0	0	0	497	497
3R	19977151	0	0	0	0	0
3R	20037752	0	25	0	34	59
3R	20253305	3	0	1	0	4
3R	20253308	2	0	1	0	3
3R	20254800	0	0	0	0	0
3R	20322199	104	0	89	0	193
3R	20323426	0	0	110	0	110
3R	20397317	0	0	0	4	4
3R	20397347	0	0	0	3	3
3R	20397348	0	0	0	3	3
3R	20397350	0	1	0	2	3
3R	20397351	0	1	0	2	3
3R	20397356	0	0	0	3	3
3R	20397361	0	0	0	2	2
3R	20397362	0	0	0	2	2
3R	20397364	0	0	0	2	2
3R	20397502	0	0	0	3	3
3R	20397510	0	0	0	3	3
3R	20397511	0	0	0	3	3
3R	20397525	0	1	0	1	2
3R	20397526	0	1	0	1	2
3R	20397527	0	0	0	2	2
3R	20442288	0	0	0	6	6
3R	20538040	0	0	0	14	14
3R	20964328	1556	0	890	0	2446
3R	20965039	1352	0	876	0	2228
3R	20978916	68	0	13	0	81
3R	20986865	2	0	0	0	2
3R	20993738	58	0	190	0	248
3R	20993841	54	0	173	0	227
3R	20993853	94	0	127	0	221
3R	21010468	49	0	7	0	56
3R	21010472	48	0	8	0	56
3R	21018588	20	0	57	0	77
3R	21018593	70	0	3	0	73
3R	21018596	24	0	51	0	75
3R	21018660	45	0	50	0	95
3R	21018693	12	0	78	0	90
3R	21018789	68	0	8	0	76
3R	21020302	22	0	13	0	35
3R	21020304	31	0	4	0	35
3R	21020562	12	0	12	0	24
3R	21032796	0	0	0	8	8
3R	21034155	0	1	0	2	3
3R	21035203	0	1	0	1	2
3R	21035311	0	1	0	3	4
3R	21036317	0	0	0	3	3
3R	21210519	14	0	0	0	14
3R	21213783	86	0	28	0	114
3R	21216016	60	0	0	0	60
3R	21228047	12	0	36	0	48
3R	21228182	17	0	40	0	57
3R	21268995	0	0	0	181	181
3R	21275768	0	0	0	244	244
3R	21277235	0	7	0	8	15
3R	21297848	304	0	23	0	327
3R	21316786	0	0	0	4	4
3R	21337167	0	7	0	35	42
3R	21360556	0	0	0	0	0
3R	21580556	0	16	0	0	16
3R	21795674	0	0	0	2	2
3R	21866357	0	2	0	0	2
3R	21979019	0	0	0	5	5
3R	22782190	6	0	0	0	6
3R	22784953	27	0	13	0	40
3R	23061604	16	0	0	0	16
3R	23081390	0	1	0	586	587
3R	23092053	0	0	0	2	2
3R	23112549	0	0	0	563	563
3R	23124996	0	8	0	3	11
3R	23124998	0	0	0	11	11
3R	23125099	0	0	0	16	16
3R	23125127	0	0	0	15	15
3R	23125179	0	0	0	13	13
3R	23125191	0	9	0	3	12
3R	23180642	0	0	1	0	1
3R	23183620	0	0	37	0	37
3R	23188969	0	227	0	0	227
3R	23191853	0	137	0	0	137
3R	23200370	0	8	0	0	8
3R	23228940	0	168	0	0	168
3R	23229652	0	0	0	72	72
3R	23229765	0	1	0	106	107
3R	23245868	0	0	0	0	0
3R	23248865	0	0	0	56	56
3R	23252005	0	0	0	0	0
3R	23261644	0	9	0	2	11
3R	23348613	2	0	0	0	2
3R	23348619	2	0	0	0	2
3R	23348769	2	0	0	0	2
3R	23348836	1	0	0	0	1
3R	23349750	1	0	0	0	1
3R	23355233	0	0	0	5	5
3R	23379528	0	0	0	36	36
3R	23662171	0	0	0	0	0
3R	23662433	0	0	0	0	0
3R	23806927	0	0	0	13	13
3R	23807724	0	28	0	0	28
3R	23812871	0	0	0	73	73
3R	23847794	0	0	97	0	97
3R	23848537	48	0	61	0	109
3R	23889222	0	0	0	8	8
3R	23889403	0	0	0	7	7
3R	23903183	0	0	0	46	46
3R	23906410	0	0	0	2	2
3R	23913774	0	0	0	1	1
3R	23930726	0	108	0	0	108
3R	23936205	0	778	0	0	778
3R	23941852	0	0	0	0	0
3R	23954031	0	48	0	0	48
3R	23954205	0	54	0	0	54
3R	23954270	0	42	0	0	42
3R	23975656	0	0	12	0	12
3R	23976395	0	0	321	0	321
3R	23981667	56	0	25	0	81
3R	23982357	275	0	35	0	310
3R	23983504	329	0	62	0	391
3R	23999913	0	113	0	0	113
3R	24000236	0	151	0	0	151
3R	24000858	0	3	0	13	16
3R	24028532	0	0	0	0	0
3R	24028545	0	0	0	0	0
3R	24035862	0	76	0	0	76
3R	24038324	0	0	26	0	26
3R	24051777	0	0	141	0	141
3R	24059369	0	0	20	0	20
3R	24059405	0	0	22	0	22
3R	24063411	20	0	0	0	20
3R	24065016	0	26	0	0	26
3R	24079314	0	1	0	0	1
3R	24080205	0	0	0	0	0
3R	24080856	0	1	0	0	1
3R	24089901	0	0	0	0	0
3R	24094522	0	2	0	0	2
3R	24096044	0	1	0	0	1
3R	24103714	0	55	0	219	274
3R	24115231	0	122	0	0	122
3R	24136443	0	0	33	0	33
3R	24136633	0	0	26	0	26
3R	24136663	0	0	29	0	29
3R	24141432	0	0	22	0	22
3R	24157937	0	51	0	0	51
3R	24162927	0	33	0	0	33
3R	24214769	0	3	0	0	3
3R	24228774	0	8	0	0	8
3R	24235203	0	0	0	0	0
3R	24292106	31	0	0	0	31
3R	24308629	51	0	21	0	72
3R	24309492	60	0	22	0	82
3R	24311331	25	0	28	0	53
3R	24399715	24	0	0	0	24
3R	24401818	0	23	0	42	65
3R	24511651	0	21	0	76	97
3R	24511656	0	23	0	75	98
3R	24512020	0	4	0	10	14
3R	24512901	0	1	0	12	13
3R	24512911	0	3	0	12	15
3R	24600699	0	0	0	0	0
3R	24668815	36	0	4	0	40
3R	24674513	149	0	15	1	165
3R	24675475	27	0	0	0	27
3R	24675663	9	0	108	0	117
3R	24690643	7	0	1	0	8
3R	24691493	134	0	15	0	149
3R	24692577	3	0	8	0	11
3R	24697793	17	0	2	0	19
3R	24706551	26	0	242	0	268
3R	24707423	53	0	161	0	214
3R	24707696	160	0	61	0	221
3R	24707890	229	0	39	0	268
3R	24708326	109	0	25	0	134
3R	24708329	79	0	49	0	128
3R	24708330	83	0	47	0	130
3R	24708356	103	0	23	0	126
3R	24829203	0	0	0	84	84
3R	25026672	22	0	0	0	22
3R	25039627	225	0	0	0	225
3R	25134628	0	0	1	0	1
3R	25136056	51	0	0	0	51
3R	25268354	3	0	0	0	3
3R	25346655	0	12	0	71	83
3R	25516393	3	0	0	0	3
3R	25530500	0	0	0	0	0
3R	25607422	0	0	0	9	9
3R	25680862	73	0	0	0	73
3R	25871448	40	0	0	0	40
3R	25871506	40	0	0	0	40
3R	25871531	42	0	0	0	42
3R	25871712	34	0	0	0	34
3R	25871911	33	0	0	0	33
3R	25965631	275	0	87	0	362
3R	25965643	0	0	364	0	364
3R	26275388	20	0	0	0	20
3R	26344955	0	0	0	0	0
3R	26384361	0	0	0	1	1
3R	26533202	0	0	0	0	0
3R	26533203	0	0	0	0	0
3R	26533204	0	0	0	0	0
3R	26533205	0	0	0	0	0
3R	26544601	0	0	0	0	0
3R	26555239	78	0	34	0	112
3R	26572578	3	0	0	0	3
3R	26593045	8	0	0	0	8
3R	26601314	0	0	81	0	81
3R	26681389	0	0	0	58	58
3R	26698436	0	0	0	200	200
3R	26699744	0	124	0	220	344
3R	26703453	0	0	0	6	6
3R	26706990	0	0	0	0	0
3R	26707060	0	0	0	0	0
3R	26710227	0	0	0	0	0
3R	26710639	0	0	0	0	0
3R	26711278	0	0	0	0	0
3R	26711482	0	0	0	0	0
3R	26722743	0	0	0	64	64
3R	26799601	0	0	0	0	0
3R	26803090	0	0	0	0	0
3R	26839293	0	0	75	0	75
3R	26839692	74	0	0	0	74
3R	26854725	0	0	0	1	1
3R	26869981	0	0	0	635	635
3R	26870035	0	0	0	667	667
3R	26898498	1	0	0	0	1
3R	26922349	0	0	0	0	0
3R	26941648	95	0	0	0	95
3R	26942517	0	0	106	0	106
3R	26950965	0	0	0	254	254
3R	26964540	0	8	0	0	8
3R	26971309	40	0	0	0	40
3R	27006713	0	0	0	0	0
3R	27059393	0	0	0	1	1
3R	27065920	0	0	0	72	72
3R	27065932	0	0	0	59	59
3R	27101403	0	0	0	9	9
3R	27155499	257	0	0	0	257
3R	27159080	73	0	0	0	73
3R	27237462	0	0	0	85	85
3R	27255644	104	0	0	0	104
3R	27260195	0	0	0	54	54
3R	27275221	4	0	1	0	5
3R	27436670	0	0	0	23	23
3R	27581330	0	3	0	6	9
3R	27610850	0	0	0	0	0
3R	27643914	0	34	0	225	259
3R	27669340	107	0	52	0	159
3R	27673172	122	0	107	0	229
3R	27673289	37	0	186	0	223
3R	27674209	120	1	0	0	121
3R	27674284	126	0	0	0	126
3R	27674568	79	0	147	0	226
3R	27674719	168	0	67	0	235
3R	27674736	18	0	215	0	233
3R	27674878	56	0	201	0	257
3R	27674907	103	0	173	0	276
3R	27675074	249	0	79	0	328
3R	27676160	263	0	75	0	338
3R	27676232	140	0	123	0	263
3R	27923909	0	0	0	0	0
3R	27928133	0	2	0	0	2
3R	27949844	0	0	110	0	110
3R	27954914	0	5	0	0	5
3R	27955650	0	0	18	0	18
3R	27956797	0	0	18	0	18
3R	27957947	0	36	0	0	36
3R	27965771	0	0	17	0	17
3R	27965792	0	0	17	0	17
3R	27966580	0	0	21	0	21
3R	27987451	0	0	0	0	0
3R	28077291	0	0	1	0	1
3R	28211257	0	0	0	0	0
3R	28418412	74	0	0	0	74
3R	28598794	0	19	0	17	36
3R	28630348	0	0	0	0	0
3R	28740661	0	0	0	0	0
3R	28755588	0	0	0	0	0
3R	28755612	0	0	0	0	0
3R	28824334	9	0	0	0	9
3R	28825660	0	71	0	0	71
3R	28834732	0	68	0	0	68
3R	28841035	0	0	0	0	0
3R	28842883	0	0	0	0	0
3R	28845314	0	4	0	0	4
3R	28845906	0	0	27	0	27
3R	28874903	51	0	0	0	51
3R	28877734	0	0	0	4	4
3R	28883203	0	0	0	1	1
3R	28893176	0	0	30	0	30
3R	28903133	13	0	0	0	13
3R	28910138	26	0	0	0	26
3R	28925501	0	0	0	41	41
3R	29682986	8	0	3	0	11
3R	29725169	0	0	35	0	35
3R	29809019	0	0	3	0	3
3R	29852709	34	0	0	0	34
3R	29877130	87	0	0	0	87
3R	29877330	111	0	0	0	111
3R	29877364	93	0	0	0	93
3R	29990367	36	0	0	0	36
3R	29991674	0	0	0	28	28
3R	30002686	0	0	0	76	76
3R	30012340	0	0	0	2	2
3R	30012471	0	0	0	6	6
3R	30014618	0	0	0	13	13
3R	30036766	0	0	0	9	9
3R	30040555	22	0	0	0	22
3R	30083131	3	0	0	0	3
3R	30092365	15	0	0	0	15
3R	30103150	27	0	0	0	27
3R	30104256	168	0	0	0	168
3R	30112301	0	0	227	0	227
3R	30113784	45	0	0	0	45
3R	30114780	30	1	0	0	31
3R	30115158	24	0	0	0	24
3R	30199030	0	0	0	1	1
3R	30303048	1	0	0	0	1
3R	30420927	0	0	0	84	84
3R	30774448	21	0	0	0	21
3R	30796901	0	0	0	0	0
3R	31046504	10	0	3	0	13
3R	31160434	4	0	0	0	4
3R	31228686	71	0	11	0	82
3R	31597431	0	76	0	234	310
3R	31597432	0	112	0	199	311
3R	31599016	0	82	0	698	780
3R	31601718	0	190	0	401	591
3R	31601828	0	139	0	726	865
3R	31602191	0	199	0	885	1084
3R	31608331	0	8	0	14	22
3R	31724907	1	0	0	0	1
3R	31837086	22	0	37	0	59
3R	31837089	17	0	41	0	58
3R	31844215	46	0	29	0	75
3R	31844748	62	0	12	0	74
4	55144	0	0	0	1	1
4	76506	1	0	0	0	1
4	86500	0	0	0	0	0
4	100011	25	0	0	0	25
4	100035	5	0	15	0	20
4	100181	1	0	22	0	23
4	100197	16	0	8	0	24
4	100200	21	0	4	0	25
4	100204	15	0	10	0	25
4	100214	16	0	7	0	23
4	100219	12	0	3	2	17
4	100289	30	0	15	0	45
4	100442	59	0	3	0	62
4	100530	47	1	5	0	53
4	100539	48	0	8	0	56
4	100543	29	0	30	0	59
4	100547	51	0	6	0	57
4	100549	27	0	32	0	59
4	100554	33	0	22	0	55
4	100556	55	0	0	0	55
4	100557	28	0	27	0	55
4	100558	39	0	15	0	54
4	100559	40	0	14	0	54
4	100560	14	0	40	0	54
4	100563	3	0	51	0	54
4	100629	20	0	18	0	38
4	101660	16	0	61	0	77
4	102327	57	0	36	0	93
4	102349	32	0	45	0	77
4	113007	108	0	62	1	171
4	126831	0	0	0	0	0
4	126842	0	0	0	0	0
4	128747	0	0	0	0	0
4	182444	0	0	0	5	5
4	182525	0	0	0	5	5
4	191689	0	17	0	16	33
4	191704	0	16	0	18	34
4	191708	0	13	0	20	33
4	192653	0	6	0	16	22
4	192661	0	18	0	5	23
4	192670	0	12	0	12	24
4	192672	0	5	0	18	23
4	192677	0	16	0	7	23
4	192684	0	10	0	16	26
4	192692	0	14	0	15	29
4	192715	0	17	0	14	31
4	192723	0	13	0	18	31
4	192724	0	14	0	16	30
4	213353	7	0	21	0	28
4	213371	20	0	10	0	30
4	214241	19	0	3	0	22
4	234621	3	0	3	0	6
4	234717	5	0	1	0	6
4	234747	1	0	4	0	5
4	234775	3	0	2	0	5
4	234798	5	0	0	0	5
4	235270	3	0	1	0	4
4	235273	4	0	0	0	4
4	235277	4	0	0	0	4
4	235278	4	0	0	0	4
4	235280	4	0	0	0	4
4	235284	3	0	0	0	3
4	235287	1	0	2	0	3
4	235308	2	0	0	0	2
4	235309	2	0	0	0	2
4	235310	2	0	0	0	2
4	235311	2	0	0	0	2
4	235313	2	0	0	0	2
4	235317	1	0	1	0	2
4	235319	2	0	0	0	2
4	235336	1	0	0	0	1
4	235338	1	0	0	0	1
4	235343	2	0	0	0	2
4	235344	2	0	0	0	2
4	235495	6	0	1	0	7
4	235496	6	0	1	0	7
4	235506	6	0	0	0	6
4	265270	24	0	0	0	24
4	265273	25	0	0	0	25
4	292019	0	2	0	0	2
4	292441	0	2	0	0	2
4	294654	0	1	0	0	1
4	295725	0	2	0	2	4
4	304161	0	2	0	0	2
4	328580	0	9	0	9	18
4	339075	0	12	0	28	40
4	340376	0	8	0	12	20
4	340381	0	6	0	14	20
4	340398	0	5	0	14	19
4	341198	0	1	0	25	26
4	341200	0	3	0	23	26
4	343860	0	1	0	1	2
4	351351	0	0	0	2	2
4	351417	0	0	0	3	3
4	356697	0	3	0	2	5
4	356702	0	1	0	4	5
4	356711	0	4	0	1	5
4	356722	0	3	0	2	5
4	356723	0	4	0	1	5
4	356726	0	2	0	3	5
4	356734	0	2	0	3	5
4	356773	0	4	0	1	5
4	357621	0	4	0	0	4
4	357626	0	3	0	0	3
4	357672	0	3	0	0	3
4	357673	0	3	0	0	3
4	367899	8	0	0	0	8
4	403085	2	0	0	0	2
4	446514	78	0	22	0	100
4	446530	93	0	16	0	109
4	448154	22	0	14	0	36
4	448773	35	0	11	0	46
4	449601	87	0	7	0	94
4	449602	72	0	15	0	87
4	449672	62	0	8	0	70
4	449705	58	0	5	0	63
4	449711	54	0	9	0	63
4	449740	49	0	10	0	59
4	449751	40	0	14	0	54
4	449767	48	0	12	0	60
4	454069	59	0	6	0	65
4	454073	62	0	0	0	62
4	454076	56	0	7	0	63
4	454085	49	0	12	0	61
4	455119	6	0	3	0	9
4	455123	8	0	2	0	10
4	455582	15	0	2	0	17
4	455778	2	0	0	0	2
4	459603	18	0	0	0	18
4	459637	14	0	0	0	14
4	476665	0	1	0	8	9
4	476688	0	4	0	2	6
4	476701	0	2	0	4	6
4	476921	0	9	0	8	17
4	520535	0	0	0	0	0
4	541492	0	11	0	18	29
4	541536	0	16	0	8	24
4	541538	0	12	0	12	24
4	541539	0	23	0	1	24
4	541545	0	9	0	15	24
4	541585	0	11	0	14	25
4	541776	0	6	0	12	18
4	541778	0	11	0	9	20
4	541780	0	0	0	20	20
4	541782	0	13	0	7	20
4	541784	0	12	0	6	18
4	541793	19	0	0	0	19
4	541795	0	0	0	21	21
4	541819	0	3	0	20	23
4	541822	0	1	0	22	23
4	541825	0	1	0	21	22
4	541826	0	3	0	18	21
4	541828	0	3	0	20	23
4	541882	0	0	0	28	28
4	541884	0	1	0	27	28
4	541886	0	2	0	27	29
4	541887	0	1	0	26	27
4	541889	0	1	0	28	29
4	541890	0	0	0	25	25
4	560912	35	0	9	0	44
4	560934	31	0	15	0	46
4	561097	25	0	13	0	38
4	563220	4	0	0	0	4
4	563252	3	0	0	0	3
4	563258	2	0	1	0	3
4	563274	2	0	1	0	3
4	563284	3	0	0	0	3
4	563291	1	0	0	0	1
4	563330	1	0	0	0	1
4	563333	2	0	0	0	2
4	563340	2	0	0	0	2
4	563347	2	0	0	0	2
4	563352	1	0	1	0	2
4	563354	2	0	0	0	2
4	563367	2	0	1	0	3
4	563368	1	0	2	0	3
4	563369	3	0	0	0	3
4	563370	1	0	2	0	3
4	563373	2	0	2	0	4
4	563377	3	0	1	0	4
4	563380	3	0	1	0	4
4	563383	4	0	0	0	4
4	563384	0	0	4	0	4
4	563385	0	0	4	0	4
4	563386	4	0	1	0	5
4	563390	2	0	4	0	6
4	563396	5	0	1	0	6
4	563398	4	0	2	0	6
4	563399	2	0	4	0	6
4	563401	5	0	1	0	6
4	563402	1	0	4	0	5
4	563403	0	0	5	0	5
4	563405	5	0	0	0	5
4	563409	4	0	2	0	6
4	563414	4	0	2	0	6
4	563416	6	0	0	0	6
4	563537	14	0	0	0	14
4	579932	7	0	0	0	7
4	579972	7	0	0	0	7
4	579974	7	0	0	0	7
4	579978	6	0	1	0	7
4	579980	5	0	1	0	6
4	602510	0	7	0	7	14
4	612525	5	0	0	0	5
4	636945	0	1	0	3	4
4	638429	0	0	0	13	13
4	653771	0	0	0	0	0
4	654895	0	9	0	17	26
4	654898	0	5	0	19	24
4	659412	0	2	0	31	33
4	667083	30	0	2	0	32
4	667084	26	0	6	0	32
4	667085	27	0	4	0	31
4	667101	17	0	8	0	25
4	667104	15	0	10	0	25
4	668200	31	0	3	0	34
4	668202	20	0	15	0	35
4	686912	46	0	16	0	62
4	686921	41	0	17	0	58
4	686924	35	0	21	0	56
4	686926	49	0	6	0	55
4	686929	24	0	34	0	58
4	686932	24	0	33	0	57
4	686941	49	0	8	0	57
4	686958	39	0	15	0	54
4	686973	45	0	8	0	53
4	686981	54	0	5	0	59
4	687294	12	0	18	0	30
4	688162	65	0	11	0	76
4	725144	0	0	0	0	0
4	743070	42	0	3	0	45
4	744196	0	0	0	0	0
4	744197	0	0	0	0	0
4	744213	0	0	0	0	0
4	744215	0	0	0	0	0
4	744797	0	0	0	0	0
4	744886	0	0	0	0	0
4	744897	0	0	0	0	0
4	745047	1	0	0	0	1
4	745107	2	0	0	0	2
4	747687	63	0	1	0	64
4	747738	34	0	22	0	56
4	767187	174	0	10	0	184
4	767264	140	0	17	1	158
4	823281	0	0	0	0	0
4	856273	0	2	0	10	12
4	856282	0	0	0	9	9
4	856311	0	7	0	4	11
4	856324	0	0	0	10	10
4	856326	0	6	0	5	11
4	856328	0	1	0	9	10
4	856331	0	3	0	8	11
4	856359	0	8	0	2	10
4	856373	0	1	0	7	8
4	857770	0	6	0	1	7
4	858835	0	6	0	7	13
4	858841	0	3	0	10	13
4	860159	0	4	0	7	11
4	860173	0	2	0	8	10
4	860227	0	6	0	3	9
4	860232	0	1	0	8	9
4	860236	0	1	0	8	9
4	874383	0	219	0	97	316
4	878970	0	111	0	315	426
4	879448	0	7	0	52	59
4	879496	0	35	0	12	47
4	879936	0	8	0	82	90
4	882370	0	29	0	58	87
4	889066	0	80	0	38	118
4	895648	0	0	0	1	1
4	896129	0	0	0	0	0
4	896139	0	0	0	0	0
4	896192	0	0	0	0	0
4	897223	0	0	0	3	3
4	897246	0	0	0	3	3
4	897262	0	0	0	3	3
4	897309	0	2	0	1	3
4	908982	0	4	0	7	11
4	980493	0	0	1	0	1
4	980622	0	0	1	0	1
4	999228	6	0	3	0	9
4	1039524	0	5	0	86	91
4	1039649	0	6	0	72	78
4	1040392	0	2	0	80	82
4	1040397	0	23	0	67	90
4	1041214	0	58	0	76	134
4	1041225	0	73	0	106	179
4	1041307	0	133	0	52	185
4	1041381	0	42	0	145	187
4	1041388	0	35	0	151	186
4	1041389	0	22	0	163	185
4	1041395	0	37	0	143	180
4	1041418	0	21	0	162	183
4	1041449	0	18	0	145	163
4	1041451	0	75	0	92	167
4	1041452	0	23	0	145	168
4	1041464	0	2	0	152	154
4	1041465	0	11	0	146	157
4	1041478	0	34	0	113	147
4	1041482	0	19	0	124	143
4	1041483	0	7	0	138	145
4	1041494	0	72	0	60	132
4	1041500	0	13	0	114	127
4	1041514	0	37	0	104	141
4	1041521	1	20	0	115	136
4	1041544	0	29	0	97	126
4	1042206	0	35	0	98	133
4	1042231	0	26	0	131	157
4	1042257	0	46	0	110	156
4	1042367	0	11	0	165	176
4	1042368	0	19	0	165	184
4	1042371	0	77	0	101	178
4	1042502	0	71	0	93	164
4	1042610	0	84	0	104	188
4	1042667	0	21	0	169	190
4	1042794	0	8	0	180	188
4	1042907	0	23	1	112	136
4	1042971	0	7	0	113	120
4	1042975	0	11	0	111	122
4	1045395	0	0	0	1	1
4	1045396	0	0	0	1	1
4	1046984	0	2	0	2	4
4	1046986	0	1	0	3	4
4	1046987	0	0	0	4	4
4	1051636	0	13	0	8	21
4	1052332	0	1	0	4	5
4	1125511	1	0	0	0	1
4	1125515	1	0	0	0	1
4	1125529	0	0	2	0	2
4	1125587	1	0	2	0	3
4	1125632	2	0	0	0	2
4	1126049	1	0	0	0	1
4	1126064	1	0	0	0	1
4	1126065	1	0	0	0	1
4	1126078	1	0	0	0	1
4	1126349	2	0	0	0	2
4	1132912	25	0	12	0	37
4	1132913	32	0	5	0	37
4	1132915	8	0	28	0	36
4	1132917	28	0	7	0	35
4	1132932	33	0	3	0	36
4	1132946	18	0	18	0	36
4	1133654	9	0	46	0	55
4	1133655	26	0	30	0	56
4	1134443	127	0	42	0	169
4	1134452	132	0	23	0	155
4	1134469	107	0	45	0	152
4	1134830	83	0	9	0	92
4	1134861	25	0	62	0	87
4	1134869	72	0	26	0	98
4	1136039	30	0	5	0	35
4	1136068	26	0	3	0	29
4	1137308	3	0	20	0	23
4	1148236	0	0	3	0	3
4	1148466	0	0	0	0	0
4	1168877	6	0	12	0	18
4	1232612	1	0	3	0	4
4	1232942	4	0	3	0	7
4	1234422	3	0	5	0	8
4	1234429	9	0	0	0	9
4	1244706	7	0	12	0	19
4	1244726	13	0	0	0	13
4	1244727	9	0	3	0	12
4	1252829	17	0	35	0	52
4	1252993	36	0	8	0	44
4	1254576	23	0	13	0	36
4	1255125	31	0	6	0	37
4	1255131	22	0	13	0	35
4	1255132	28	0	5	0	33
4	1255154	35	0	7	0	42
4	1255163	40	0	1	0	41
4	1255168	34	0	5	0	39
4	1257070	12	0	11	0	23
4	1257336	19	0	4	0	23
4	1257543	14	0	4	0	18
4	1257984	41	0	8	0	49
4	1260280	3	0	11	0	14
4	1260284	8	0	9	0	17
4	1265107	141	0	203	1	345
4	1267648	5	0	3	0	8
Un_DS483999v1	2471	0	0	0	0	0
Un_DS484083v1	1024	0	0	0	0	0
Un_DS484090v1	1859	0	0	0	0	0
Un_DS484176v1	2586	0	0	0	0	0
Un_DS484511v1	1204	0	0	0	0	0
Un_DS484539v1	1135	0	0	0	0	0
Un_DS484746v1	578	0	0	0	0	0
Un_DS485536v1	813	0	0	0	0	0
Un_DS485605v1	551	0	0	0	0	0
X	514252	0	39	0	43	82
X	514297	0	15	0	58	73
X	514298	0	27	0	43	70
X	516944	0	10	0	41	51
X	516949	0	10	0	40	50
X	516964	0	13	0	39	52
X	923306	0	0	0	68	68
X	923307	0	0	0	67	67
X	924277	0	74	0	42	116
X	1373346	171	0	102	0	273
X	1373528	90	0	97	0	187
X	1373589	124	0	36	0	160
X	1373602	140	0	33	0	173
X	1378095	207	0	76	0	283
X	1378279	127	0	98	0	225
X	1378284	103	0	129	0	232
X	1491577	0	20	1	17	38
X	1676057	0	95	0	11	106
X	1676066	0	34	0	74	108
X	1676597	1	133	0	35	169
X	1690573	0	53	0	100	153
X	1781840	61	0	47	0	108
X	1784005	49	0	44	0	93
X	1784034	67	0	31	0	98
X	1784035	82	0	17	0	99
X	1784036	60	0	39	0	99
X	1785204	140	0	6	0	146
X	1785212	128	0	12	0	140
X	1785216	102	0	40	0	142
X	1785256	127	0	1	0	128
X	1785441	109	0	3	0	112
X	1785444	113	0	5	0	118
X	1785543	85	0	9	0	94
X	1785888	21	0	45	0	66
X	1785903	50	0	15	0	65
X	1786528	107	0	2	0	109
X	1854163	0	0	0	0	0
X	1854164	0	0	0	0	0
X	2078771	0	0	0	73	73
X	2112342	135	0	52	0	187
X	2112355	176	0	21	0	197
X	2112356	144	0	53	0	197
X	2180389	0	0	0	0	0
X	2219688	0	7	0	6	13
X	2376647	0	19	0	7	26
X	2434676	0	4	0	2	6
X	2515228	0	0	0	4	4
X	2625116	1	0	0	0	1
X	2628866	70	0	133	0	203
X	2660761	136	0	0	0	136
X	2667642	2	0	0	0	2
X	2677613	146	0	7	0	153
X	2678338	104	0	7	0	111
X	2678342	85	0	24	0	109
X	3297989	4	0	0	0	4
X	3342781	3	0	3	0	6
X	3343393	38	0	0	0	38
X	3477696	0	0	0	54	54
X	3719089	0	1	0	1	2
X	3730329	0	0	0	0	0
X	3859628	0	403	0	1840	2243
X	3859645	0	572	0	1595	2167
X	3860640	0	284	0	2005	2289
X	3860692	0	301	0	2100	2401
X	3860693	0	1164	0	1222	2386
X	3860694	0	248	0	2160	2408
X	3861312	5	180	0	1483	1668
X	3861498	0	416	2	1478	1896
X	3861499	1	359	2	1485	1847
X	3861500	0	198	0	1726	1924
X	3861501	2	1614	0	215	1831
X	3861505	0	1346	0	478	1824
X	3895378	0	3	0	46	49
X	3953264	185	0	100	0	285
X	4102802	0	0	0	0	0
X	4217290	0	0	0	0	0
X	4352383	4	0	3	0	7
X	4356397	45	1	1	0	47
X	4689184	0	0	0	0	0
X	4689563	0	0	1	0	1
X	4701126	0	1	0	289	290
X	4711852	0	0	0	0	0
X	4981377	0	0	0	0	0
X	5087477	1	0	6	0	7
X	5170349	33	0	4	0	37
X	5239523	68	0	11	0	79
X	5251934	0	0	0	97	97
X	5252342	35	0	19	0	54
X	5360710	2	0	1	0	3
X	5396519	52	0	45	1	98
X	5397332	3	0	11	0	14
X	5397347	8	0	6	0	14
X	5397612	16	0	5	0	21
X	5630114	0	502	0	82	584
X	5630195	0	69	0	583	652
X	5630213	0	318	0	357	675
X	5630234	0	510	0	126	636
X	5630342	0	300	0	273	573
X	5630737	0	50	10	447	507
X	5631026	0	214	0	166	380
X	5631035	0	327	0	43	370
X	5631048	0	346	0	61	407
X	5788690	0	0	19	0	19
X	5810061	0	0	0	0	0
X	5963943	0	2	0	0	2
X	5998043	0	0	0	31	31
X	6105139	0	4	0	86	90
X	6107611	0	119	0	250	369
X	6107620	0	210	0	161	371
X	6107716	0	86	0	44	130
X	6108552	1	231	0	63	295
X	6108553	0	277	0	13	290
X	6108712	0	195	0	9	204
X	6108766	0	90	0	134	224
X	6109871	0	44	0	231	275
X	6112645	0	15	0	180	195
X	6115425	0	201	0	22	223
X	6145386	0	24	0	130	154
X	6184321	0	0	0	0	0
X	6531547	0	0	0	0	0
X	6537186	0	0	15	0	15
X	6577785	5	0	1	0	6
X	6790259	0	3	0	2	5
X	7085816	0	96	0	30	126
X	7445827	13	0	8	0	21
X	7698223	0	1	0	0	1
X	7912801	69	0	0	0	69
X	7938121	0	0	0	0	0
X	7987553	0	0	0	0	0
X	8046474	0	0	0	17	17
X	8055921	0	0	0	0	0
X	8055924	0	0	0	0	0
X	8240090	50	0	103	1	154
X	8240161	98	0	45	1	144
X	8247628	220	0	131	0	351
X	8272518	0	2	0	5	7
X	8403319	5	0	18	0	23
X	8409426	0	1	0	23	24
X	8518112	5	0	1	0	6
X	8632440	0	22	0	25	47
X	8649283	0	2	0	0	2
X	8908884	0	2	0	5	7
X	8910271	0	1	0	0	1
X	8917312	5	0	0	0	5
X	8927652	1	0	1	0	2
X	8927665	0	0	1	0	1
X	8941468	3	0	1	0	4
X	8942088	6	0	0	0	6
X	8942812	2	0	0	0	2
X	8966417	7	0	1	0	8
X	9002119	0	0	0	0	0
X	9020223	23	0	46	0	69
X	9020239	37	0	30	0	67
X	9020384	4	0	62	0	66
X	9022297	0	0	0	79	79
X	9022830	89	0	11	0	100
X	9022835	17	0	82	0	99
X	9022869	8	0	59	1	68
X	9022902	63	0	2	0	65
X	9022931	46	0	43	0	89
X	9022942	54	0	35	0	89
X	9022943	77	0	14	0	91
X	9028080	122	0	90	0	212
X	9028091	117	0	105	0	222
X	9037319	0	0	0	0	0
X	9153487	1	205	2	1467	1675
X	9200948	0	0	0	2	2
X	9278576	0	14	0	23	37
X	9340169	0	0	0	0	0
X	9574655	0	62	0	21	83
X	9754490	2	0	13	0	15
X	10016995	0	0	0	0	0
X	10247964	0	3	0	28	31
X	10330625	0	0	0	0	0
X	10356486	202	0	0	0	202
X	10463690	56	0	0	0	56
X	10639732	0	0	0	0	0
X	10709480	61	0	11	0	72
X	10711327	0	0	0	26	26
X	10711351	0	0	0	26	26
X	10746485	112	0	35	0	147
X	10746488	95	0	47	0	142
X	10817179	0	0	0	0	0
X	10835849	0	51	0	28	79
X	10846781	0	44	0	39	83
X	11047667	8	0	2	0	10
X	11047679	7	0	3	0	10
X	11047750	2	0	13	0	15
X	11047753	3	0	12	0	15
X	11048103	1	0	7	0	8
X	11052798	0	189	0	121	310
X	11221249	0	1	0	30	31
X	11221253	0	2	0	28	30
X	11221255	0	3	0	27	30
X	11221259	0	2	0	28	30
X	11221261	0	0	0	30	30
X	11221263	0	2	0	28	30
X	11221265	0	0	0	29	29
X	11221267	0	1	0	28	29
X	11221296	0	1	0	30	31
X	11221308	0	2	0	30	32
X	11221310	0	0	0	32	32
X	11221312	0	1	0	32	33
X	11221318	0	2	0	31	33
X	11221322	0	1	0	30	31
X	11221325	0	4	0	29	33
X	11224387	1	28	0	21	50
X	11330935	72	1	0	0	73
X	11371626	2	0	3	0	5
X	11553315	93	0	0	0	93
X	11575555	8	0	17	0	25
X	11704179	134	0	26	0	160
X	11704188	90	0	59	0	149
X	11812074	0	56	0	49	105
X	11812089	0	59	0	50	109
X	11939698	0	45	0	69	114
X	11939764	0	19	0	69	88
X	11949882	0	65	0	52	117
X	11949883	0	37	0	80	117
X	11954277	0	91	0	21	112
X	11955525	0	7	0	5	12
X	11955561	0	7	0	7	14
X	11964192	0	15	0	76	91
X	11967712	0	11	0	11	22
X	11968032	0	12	0	16	28
X	11968676	0	8	0	85	93
X	11968768	0	56	0	34	90
X	11968969	0	25	0	52	77
X	11970546	0	15	0	57	72
X	11970552	0	9	0	54	63
X	11970556	0	29	0	44	73
X	11971853	0	65	0	26	91
X	11977538	0	49	0	15	64
X	12178407	0	0	0	0	0
X	12234654	2	0	0	0	2
X	12321994	0	0	135	0	135
X	12411368	0	0	0	0	0
X	12446818	24	0	7	0	31
X	12517682	0	11	0	31	42
X	12517716	0	4	0	41	45
X	12530707	0	0	0	0	0
X	12570094	0	9	0	18	27
X	12570147	0	14	0	8	22
X	12610058	0	0	0	66	66
X	12633103	5	0	9	0	14
X	12638680	278	0	60	0	338
X	12670776	1	0	0	0	1
X	12772709	22	0	16	0	38
X	12779207	0	1	0	2	3
X	12836423	0	0	0	0	0
X	12920895	4	0	0	0	4
X	13075382	37	0	81	0	118
X	13326657	0	0	42	0	42
X	13338794	32	0	0	0	32
X	13363027	0	0	0	0	0
X	13363147	0	0	5	0	5
X	13364994	28	0	17	0	45
X	13375332	0	0	3	0	3
X	13713539	32	0	2	0	34
X	13713540	30	0	3	0	33
X	13713557	36	0	2	0	38
X	13713560	36	0	1	0	37
X	13713989	15	0	9	0	24
X	13714028	26	0	2	0	28
X	13714030	19	0	9	0	28
X	13714099	32	0	2	0	34
X	13714108	32	0	3	0	35
X	13915030	0	3	0	0	3
X	13960364	0	0	0	0	0
X	13981405	0	0	0	0	0
X	13988603	0	2	0	11	13
X	14017285	0	0	0	0	0
X	14272086	72	0	32	0	104
X	14272092	5	0	101	0	106
X	14272096	4	0	101	0	105
X	14274268	64	0	26	0	90
X	14791453	0	17	0	104	121
X	14803625	0	0	0	1	1
X	14827027	0	9	1	39	49
X	14827028	0	20	1	35	56
X	14827029	0	22	0	33	55
X	14904567	712	0	0	0	712
X	14932507	34	0	16	0	50
X	14996674	34	0	37	0	71
X	14999166	7	0	6	0	13
X	14999641	7	0	5	0	12
X	14999868	6	0	69	0	75
X	14999920	86	0	12	0	98
X	14999924	9	0	87	0	96
X	14999938	77	0	5	0	82
X	15000623	19	0	73	0	92
X	15002265	25	0	18	0	43
X	15004413	25	0	69	0	94
X	15004776	21	0	72	0	93
X	15004857	33	0	79	0	112
X	15004878	81	0	31	0	112
X	15043300	0	0	0	1	1
X	15058391	0	33	0	12	45
X	15098493	77	0	64	0	141
X	15098592	67	0	91	0	158
X	15111879	43	0	83	0	126
X	15112038	54	0	1	0	55
X	15304670	1	0	0	0	1
X	15388627	0	12	0	48	60
X	15392685	0	117	0	23	140
X	15483634	27	0	0	0	27
X	15484167	14	0	2	0	16
X	15501741	0	0	0	0	0
X	15531613	0	0	0	0	0
X	15581889	0	13	0	0	13
X	15897294	311	0	297	0	608
X	15897759	25	0	16	0	41
X	15897789	39	0	2	0	41
X	15897854	26	0	5	0	31
X	15897856	30	0	2	0	32
X	15903965	15	1	94	0	110
X	15919889	93	0	6	0	99
X	15952334	0	8	0	12	20
X	15956689	0	4	0	26	30
X	15956841	0	1	0	43	44
X	15958587	0	144	0	9	153
X	15961105	0	2	0	16	18
X	15961636	0	1	0	19	20
X	15989371	0	2	0	31	33
X	16075853	0	0	0	57	57
X	16339624	56	0	62	0	118
X	16339799	49	0	5	0	54
X	16456420	0	1	0	28	29
X	16456425	0	13	0	16	29
X	16460238	0	14	0	93	107
X	16460589	0	17	0	94	111
X	16460590	0	7	0	105	112
X	16460595	0	20	0	91	111
X	16464719	0	113	0	11	124
X	16466198	0	21	0	18	39
X	16466199	0	34	0	3	37
X	16466203	0	7	0	30	37
X	16466204	0	6	0	31	37
X	16466216	0	6	0	31	37
X	16466692	0	0	0	99	99
X	16468562	0	59	0	3	62
X	16469630	0	17	0	26	43
X	16469631	0	22	0	18	40
X	16471229	0	46	0	35	81
X	16471265	0	46	0	47	93
X	16471290	0	12	0	71	83
X	16471319	0	36	0	41	77
X	16471811	0	17	0	13	30
X	16471812	0	14	0	16	30
X	16471813	0	12	0	18	30
X	16471814	0	12	0	18	30
X	16473609	0	4	0	59	63
X	16473610	0	3	0	54	57
X	16473637	0	33	0	16	49
X	16473638	0	4	0	42	46
X	16475638	0	15	0	63	78
X	16475685	0	4	0	62	66
X	16477558	1	11	0	56	68
X	16481881	0	1	0	14	15
X	16482682	0	50	0	51	101
X	16482683	0	29	0	71	100
X	16482692	0	4	0	98	102
X	16482693	0	61	0	42	103
X	16504240	0	42	0	43	85
X	16504273	0	0	0	97	97
X	16505310	0	3	0	20	23
X	16505550	0	82	0	32	114
X	16509658	0	13	0	88	101
X	16509671	0	14	0	86	100
X	16509684	0	21	0	78	99
X	16511854	0	2	0	14	16
X	16514487	0	5	0	13	18
X	16517164	0	12	0	6	18
X	16518833	0	58	0	25	83
X	16523520	0	0	0	2	2
X	16523529	0	0	0	2	2
X	16523541	0	0	0	2	2
X	16523553	0	0	0	2	2
X	16523556	0	0	0	1	1
X	16523557	0	0	0	1	1
X	16532860	0	1	0	4	5
X	16532866	0	2	0	3	5
X	16562027	0	15	0	67	82
X	16562108	0	20	0	67	87
X	16681534	0	2	0	25	27
X	16839820	0	16	0	46	62
X	16839947	0	0	0	53	53
X	16905030	0	0	0	2	2
X	16915290	3	0	0	0	3
X	17016883	0	2	0	2	4
X	17016898	0	0	0	4	4
X	17017015	0	4	0	5	9
X	17027613	0	0	0	0	0
X	17082644	0	0	0	0	0
X	17097065	45	0	3	0	48
X	17291667	0	0	0	0	0
X	17666685	514	0	0	0	514
X	17674476	0	7	0	14	21
X	17926624	0	60	0	21	81
X	17930651	0	87	0	33	120
X	17930658	0	102	0	11	113
X	17930733	0	65	0	61	126
X	17930890	0	60	0	5	65
X	17930948	0	47	0	16	63
X	17936502	0	1	0	56	57
X	17938011	0	0	0	218	218
X	17941537	0	4	0	27	31
X	17941569	0	1	0	32	33
X	17941570	0	3	0	27	30
X	17942236	0	2	0	27	29
X	17945833	0	5	0	28	33
X	17950057	0	43	1	235	279
X	17952716	0	8	0	241	249
X	17952717	0	9	0	242	251
X	17961411	0	1	0	0	1
X	17981650	0	20	0	38	58
X	17982144	0	38	0	4	42
X	17983811	0	33	0	30	63
X	17983847	0	44	0	9	53
X	17987714	0	1	0	50	51
X	17987788	0	9	0	47	56
X	17987790	0	26	0	32	58
X	17987796	0	12	0	43	55
X	17988376	0	1	0	14	15
X	17989432	0	6	0	34	40
X	17989433	0	37	0	5	42
X	17991679	0	0	0	0	0
X	17991684	0	0	0	0	0
X	17991689	0	0	0	0	0
X	17991690	0	0	0	0	0
X	17991691	0	0	0	0	0
X	18107572	0	0	0	26	26
X	18107970	0	3	0	12	15
X	18170126	20	0	56	0	76
X	18172085	116	0	0	0	116
X	18172108	92	0	0	0	92
X	18173979	64	0	8	0	72
X	18174020	44	0	9	0	53
X	18174056	45	0	3	0	48
X	18177807	12	0	0	0	12
X	18201429	77	0	13	0	90
X	18558815	4	0	0	0	4
X	18901523	2	0	0	0	2
X	19153046	0	0	0	62	62
X	19265115	13	0	10	0	23
X	19265410	0	0	1	0	1
X	19283881	0	23	0	53	76
X	19334465	0	69	1	14	84
X	19334522	0	26	0	50	76
X	19341081	1	2	0	42	45
X	19341084	0	6	0	39	45
X	19341882	0	0	0	91	91
X	19342007	0	65	0	59	124
X	19508447	280	0	41	0	321
X	19545747	0	0	0	2	2
X	19641588	0	39	0	58	97
X	19651650	0	0	0	18	18
X	19727697	10	0	108	0	118
X	19727698	17	0	102	0	119
X	19831888	0	0	0	17	17
X	19835017	0	12	0	22	34
X	19857622	15	0	0	0	15
X	19888186	0	0	1	0	1
X	20330037	0	0	0	0	0
X	20330041	0	0	0	0	0
X	20770084	0	19	0	19	38
X	20773442	0	10	0	13	23
X	20819626	0	0	0	0	0
X	20828303	0	0	0	10	10
X	20828316	0	5	0	5	10
X	20828348	0	2	0	6	8
X	20828364	0	8	0	1	9
X	20828369	0	8	0	1	9
X	20828370	0	4	0	5	9
X	20923843	0	14	0	13	27
X	20924823	0	1	0	2	3
X	21068672	0	0	0	0	0
X	21304740	0	0	0	0	0
X	21629428	0	90	0	174	264
X	21629453	0	97	0	166	263
X	21629508	0	42	0	224	266
X	21629725	0	163	0	116	279
X	21629726	0	108	1	170	279
X	21629727	0	109	0	169	278
X	21629737	0	146	0	135	281
X	22489005	3	0	1	0	4
X	22489022	4	0	0	0	4
X	22499716	49	0	10	0	59
X	22499717	32	0	28	0	60
X	22499732	27	0	36	0	63
X	22502642	221	0	35	0	256
X	22502713	62	0	180	0	242
X	22502735	199	0	52	0	251
X	22980987	0	12	0	169	181
X	22982709	0	398	0	198	596
X	22983936	0	13	0	7	20
X	22984239	0	11	0	15	26
X	22984267	0	1	0	34	35
X	22984352	0	1	0	25	26
X	23024266	0	0	1	0	1
X	23029207	1	0	1	0	2
X	23206974	0	0	0	0	0
Y	400261	0	0	0	0	0
Y	688072	0	0	0	0	0
Y_CP007107v1_random	40134	0	0	0	0	0
Y_DS485767v1_random	101	0	0	0	0	0
