#CHR	POS	Count_A	Count_C	Count_G	Count_T	Good_depth
2R	669894	0	0	0	0	0
2R	927745	0	38	0	50	88
2R	927747	0	15	0	75	90
2R	927763	0	25	0	63	88
2R	927764	0	51	0	37	88
2R	927773	0	62	0	24	86
2R	928819	0	128	0	46	174
2R	928861	0	12	0	165	177
2R	928866	0	102	0	63	165
2R	928867	0	23	0	152	175
2R	946817	0	3	0	14	17
2R	947223	0	4	0	2	6
2R	948265	0	0	0	2	2
2R	949521	0	10	0	3	13
2R	1268441	6	0	2	0	8
2R	1271549	0	0	0	0	0
2R	1362581	0	0	0	0	0
2R	1397455	1	0	0	0	1
2R	1424437	0	0	0	0	0
2R	1424453	0	0	0	0	0
2R	1591958	14	0	3	0	17
2R	1593302	29	0	1	0	30
2R	1593303	28	0	2	0	30
2R	1593310	24	0	5	0	29
2R	1593315	29	0	1	0	30
2R	1593825	8	0	2	0	10
2R	1594032	17	0	5	0	22
2R	1595342	12	0	2	0	14
2R	1595440	18	0	1	0	19
2R	1607075	0	0	0	0	0
2R	1728919	0	0	0	0	0
2R	1738108	0	0	0	0	0
2R	1865062	0	5	0	3	8
2R	1865075	0	0	0	6	6
2R	1865085	0	3	0	3	6
2R	1865087	0	2	0	4	6
2R	1865348	0	0	0	2	2
2R	1865369	0	0	0	3	3
2R	1865574	0	6	0	2	8
2R	1873696	0	0	0	2	2
2R	1891695	0	0	0	1	1
2R	1893555	0	0	0	1	1
2R	1895974	0	0	0	0	0
2R	1905603	0	0	0	0	0
2R	1916341	0	0	0	0	0
2R	1917254	0	0	0	0	0
2R	1958846	0	0	0	1	1
2R	1986061	0	0	0	0	0
2R	1994663	0	0	0	0	0
2R	1994676	0	0	0	0	0
2R	2080600	0	0	0	1	1
2R	2108301	0	1	0	1	2
2R	2191810	0	0	0	0	0
2R	2194077	0	1	0	0	1
2R	2195782	0	0	0	0	0
2R	2202217	0	0	0	0	0
2R	2202225	0	0	0	0	0
2R	2241894	0	0	0	0	0
2R	2246575	0	0	0	0	0
2R	2246585	0	0	0	0	0
2R	2246586	0	0	0	0	0
2R	2246597	0	0	0	0	0
2R	2246605	0	0	0	0	0
2R	2246607	0	0	0	0	0
2R	2246610	0	0	0	0	0
2R	2246614	0	0	0	0	0
2R	2246619	0	0	0	0	0
2R	2246626	0	0	0	0	0
2R	2246628	0	0	0	0	0
2R	2246630	0	0	0	0	0
2R	2246649	0	0	0	0	0
2R	2246650	0	0	0	0	0
2R	2246657	0	0	0	0	0
2R	2246661	0	0	0	0	0
2R	2246666	0	0	0	0	0
2R	2246668	0	0	0	0	0
2R	2246670	0	0	0	0	0
2R	2246672	0	0	0	0	0
2R	2246674	0	0	0	0	0
2R	2246677	0	0	0	0	0
2R	2246691	0	0	0	0	0
2R	2246694	0	0	0	0	0
2R	2246705	0	0	0	0	0
2R	2246718	0	0	0	0	0
2R	2246721	0	0	0	0	0
2R	2246725	0	0	0	0	0
2R	2246749	0	0	0	0	0
2R	2246751	0	0	0	0	0
2R	2246758	0	0	0	0	0
2R	2247749	0	1	0	0	1
2R	2256918	0	0	0	0	0
2R	2257284	0	0	0	1	1
2R	2257289	0	0	0	1	1
2R	2257295	0	1	0	0	1
2R	2257742	0	0	0	1	1
2R	2257793	0	0	0	3	3
2R	2257825	0	0	0	3	3
2R	2257846	0	0	0	3	3
2R	2260195	0	0	0	10	10
2R	2260208	0	0	0	12	12
2R	2260246	0	0	0	13	13
2R	2260647	0	1	0	2	3
2R	2487897	0	0	0	0	0
2R	2487913	0	0	0	0	0
2R	2495761	0	4	0	38	42
2R	2496768	0	13	0	31	44
2R	2496780	0	26	0	13	39
2R	2498338	0	2	0	18	20
2R	2498339	0	0	0	19	19
2R	2498347	0	14	0	4	18
2R	2498348	0	0	0	16	16
2R	2498350	0	4	0	12	16
2R	2498351	0	9	0	8	17
2R	2498353	0	6	0	12	18
2R	2498356	0	12	0	4	16
2R	2498359	0	1	0	15	16
2R	2498363	0	12	0	4	16
2R	2498364	0	6	0	10	16
2R	2517609	0	7	0	13	20
2R	2519999	0	11	0	19	30
2R	2554231	0	3	0	5	8
2R	2554519	0	1	0	2	3
2R	2554530	0	1	0	2	3
2R	2562370	0	3	0	6	9
2R	2562467	0	2	0	7	9
2R	2563510	0	0	0	4	4
2R	2640746	0	0	0	0	0
2R	2820914	0	0	0	0	0
2R	2821043	0	0	0	0	0
2R	2822225	0	0	0	1	1
2R	2822367	0	0	0	1	1
2R	2822866	0	0	0	0	0
2R	2822867	0	0	0	0	0
2R	2822874	0	0	0	0	0
2R	2822875	0	0	0	0	0
2R	2822877	0	0	0	0	0
2R	2822880	0	0	0	0	0
2R	2822883	0	0	0	0	0
2R	2822884	0	0	0	0	0
2R	2822887	0	0	0	0	0
2R	2822888	0	0	0	0	0
2R	2822893	0	0	0	0	0
2R	2822941	0	0	0	0	0
2R	2822942	0	0	0	0	0
2R	2822956	0	0	0	0	0
2R	2822957	0	0	0	0	0
2R	2822958	0	0	0	0	0
2R	2822961	0	0	0	0	0
2R	2822991	0	0	0	0	0
2R	2822995	0	0	0	1	1
2R	2822996	0	0	0	1	1
2R	2822997	0	0	0	1	1
2R	2823003	0	0	0	1	1
2R	2823005	0	0	0	1	1
2R	2823006	0	0	0	1	1
2R	2823007	0	0	0	1	1
2R	2823097	0	0	0	1	1
2R	2823428	0	0	0	1	1
2R	2823645	0	0	0	0	0
2R	2823852	0	0	0	1	1
2R	2831098	0	0	0	0	0
2R	2831110	0	0	0	0	0
2R	2832245	0	0	0	0	0
2R	2843105	0	0	0	1	1
2R	2843112	0	0	0	1	1
2R	2843113	0	0	0	1	1
2R	2843121	0	1	0	1	2
2R	2843122	0	1	0	1	2
2R	2843124	0	1	0	1	2
2R	2843130	0	1	0	1	2
2R	2846308	0	0	0	5	5
2R	2954347	0	0	0	0	0
2R	2954369	0	0	0	0	0
2R	2954754	0	0	0	1	1
2R	2970910	0	0	0	0	0
2R	3104182	0	0	0	0	0
2R	3190285	6	0	6	0	12
2R	3919432	0	2	0	2	4
2R	3932880	0	3	0	1	4
2R	3941840	0	5	0	9	14
2R	4052078	0	0	0	0	0
2R	4052143	1	0	0	0	1
2R	4052192	2	0	0	0	2
2R	4052205	2	0	0	0	2
2R	4052208	1	0	1	0	2
2R	4052224	2	0	0	0	2
2R	4052238	1	0	1	0	2
2R	4052252	1	0	0	0	1
2R	4052268	1	0	0	0	1
2R	4052279	0	0	1	0	1
2R	4220796	0	0	0	0	0
2R	4350268	0	0	0	1	1
2R	4350386	0	0	0	1	1
2R	4367099	0	0	0	1	1
2R	4397570	0	0	0	0	0
2R	4397571	0	0	0	0	0
2R	4397577	0	0	0	0	0
2R	4397580	0	0	0	0	0
2R	4397583	0	0	0	0	0
2R	4397588	0	0	0	0	0
2R	4397601	0	0	0	0	0
2R	4397632	0	0	0	0	0
2R	4397638	0	0	0	0	0
2R	4397643	0	0	0	0	0
2R	4397645	0	0	0	0	0
2R	4397646	0	0	0	0	0
2R	4397658	0	0	0	0	0
2R	4407456	0	0	0	2	2
2R	4407479	0	0	0	2	2
2R	4470411	0	0	0	0	0
2R	4598137	2	0	5	0	7
2R	4610290	0	0	0	0	0
2R	4610327	0	0	0	0	0
2R	4610328	0	0	0	0	0
2R	4610335	0	0	0	0	0
2R	4610338	0	0	0	0	0
2R	4610340	0	0	0	0	0
2R	4610343	0	0	0	0	0
2R	4610344	0	0	0	0	0
2R	4749085	15	0	1	0	16
2R	4787711	0	12	0	81	93
2R	4790435	3	0	0	0	3
2R	4795353	0	0	0	2	2
2R	5027097	0	0	0	0	0
2R	5068277	0	5	0	1	6
2R	5069358	0	0	0	5	5
2R	5069359	0	1	0	4	5
2R	5069360	0	0	0	5	5
2R	5119406	0	6	0	17	23
2R	5120152	0	9	0	3	12
2R	5124254	0	2	0	3	5
2R	5127276	0	1	0	5	6
2R	5211451	0	0	0	0	0
2R	5302757	0	0	0	0	0
2R	5320850	8	0	1	0	9
2R	5337012	0	0	0	0	0
2R	5495400	0	0	0	7	7
2R	5503750	0	0	0	0	0
2R	5503767	0	0	0	0	0
2R	5503911	0	0	0	0	0
2R	5503915	0	0	0	0	0
2R	5504022	0	0	0	0	0
2R	5504026	0	0	0	0	0
2R	5504425	0	0	0	0	0
2R	5504526	0	0	0	0	0
2R	5505677	0	0	0	0	0
2R	5505735	0	0	0	0	0
2R	5505798	0	0	0	0	0
2R	5505800	0	0	0	0	0
2R	5505852	0	0	0	0	0
2R	6031677	0	1	0	1	2
2R	6039689	0	11	0	11	22
2R	6174962	498	0	0	0	498
2R	6571523	0	0	0	0	0
2R	6725344	0	1	0	50	51
2R	6733080	0	5	0	49	54
2R	6733220	0	2	0	53	55
2R	6817728	15	0	7	0	22
2R	6927455	0	6	1	34	41
2R	7130316	0	0	0	4	4
2R	7401894	0	0	0	0	0
2R	7501178	18	0	55	0	73
2R	7502188	16	0	45	0	61
2R	7502199	22	0	31	0	53
2R	7664923	18	0	0	0	18
2R	7813863	58	0	74	0	132
2R	8100701	47	0	33	0	80
2R	8144501	0	0	0	1	1
2R	8464487	161	0	0	0	161
2R	8482655	0	0	0	52	52
2R	8511471	0	1	0	0	1
2R	8616059	142	0	0	0	142
2R	8618670	291	0	1	0	292
2R	8696454	16	0	1	0	17
2R	8876533	80	0	20	0	100
2R	8876790	93	0	14	0	107
2R	8877577	98	0	13	0	111
2R	8883706	1	0	123	0	124
2R	8883745	73	0	52	0	125
2R	8885231	80	0	25	0	105
2R	8885377	93	0	39	0	132
2R	8903673	1419	0	99	0	1518
2R	8903674	1308	0	121	0	1429
2R	8903680	1195	0	367	0	1562
2R	8912445	0	0	0	0	0
2R	9100226	11	0	0	0	11
2R	9110821	12	0	0	0	12
2R	9119427	24	0	0	0	24
2R	9120392	21	0	70	0	91
2R	9158865	0	0	0	32	32
2R	9168104	0	0	0	43	43
2R	9171291	0	0	0	27	27
2R	9171360	0	0	0	31	31
2R	9191664	0	0	0	199	199
2R	9229669	0	32	0	204	236
2R	9229804	0	139	2	470	611
2R	9229936	0	245	0	340	585
2R	9232371	0	0	0	19	19
2R	9234514	0	316	0	253	569
2R	9234519	0	370	0	176	546
2R	9311068	0	11	0	148	159
2R	9312080	0	56	0	64	120
2R	9312087	0	60	0	60	120
2R	9312091	0	0	0	126	126
2R	9312092	121	0	0	0	121
2R	9312093	1	1	0	118	120
2R	9312094	0	5	0	118	123
2R	9328201	0	1	0	2	3
2R	9344191	0	0	0	1	1
2R	9344213	0	0	0	1	1
2R	9345714	0	2	0	8	10
2R	9369253	0	0	0	1	1
2R	9408179	0	2	0	0	2
2R	9440747	0	53	0	13	66
2R	9534930	248	4	110	0	362
2R	9534943	344	0	37	0	381
2R	9539059	0	219	0	55	274
2R	9542736	0	1	0	2	3
2R	9542851	0	0	0	7	7
2R	9592745	1	0	0	0	1
2R	9598728	10	0	0	0	10
2R	9599645	2	0	0	0	2
2R	9619360	0	0	0	0	0
2R	9633098	0	0	0	1	1
2R	9721527	0	1	0	2	3
2R	9723564	0	8	0	33	41
2R	9739197	0	0	0	0	0
2R	9753896	962	0	36	0	998
2R	9817692	0	0	0	23	23
2R	9819309	0	8	0	24	32
2R	9819328	0	8	0	22	30
2R	9819477	0	2	0	22	24
2R	9819490	0	10	0	15	25
2R	9884160	0	16	0	172	188
2R	9927725	0	0	0	0	0
2R	10011276	0	0	0	0	0
2R	10091619	18	0	0	0	18
2R	10108800	914	0	426	0	1340
2R	10108801	960	0	380	0	1340
2R	10108802	1037	0	290	0	1327
2R	10222721	0	1	0	7	8
2R	10278408	20	0	0	0	20
2R	10279089	26	0	0	0	26
2R	10280883	42	0	43	0	85
2R	10280988	35	0	50	0	85
2R	10285619	122	0	0	0	122
2R	10321544	11	0	0	0	11
2R	10327175	0	12	0	8	20
2R	10330783	0	1	0	8	9
2R	10330787	0	3	0	7	10
2R	10330795	0	0	0	9	9
2R	10330796	0	0	0	11	11
2R	10330801	0	1	0	8	9
2R	10330802	0	6	0	4	10
2R	10336774	0	17	0	59	76
2R	10378403	0	0	0	1	1
2R	10378432	0	1	0	0	1
2R	10378433	0	1	0	0	1
2R	10392192	0	0	0	12	12
2R	10393990	0	0	0	12	12
2R	10472135	0	33	0	202	235
2R	10531606	0	3	0	9	12
2R	10540485	0	0	0	3	3
2R	10611461	192	0	18	0	210
2R	10611464	181	0	34	0	215
2R	10706747	16	0	4	0	20
2R	10783584	0	0	0	0	0
2R	10785766	0	3	0	0	3
2R	10785846	0	0	0	4	4
2R	10788717	2	0	1	0	3
2R	10789955	2	0	0	0	2
2R	10815342	88	0	0	0	88
2R	10837913	0	540	0	0	540
2R	10840470	0	133	0	34	167
2R	10855471	0	0	0	0	0
2R	11148789	0	0	0	51	51
2R	11229833	0	0	0	195	195
2R	11293045	0	31	0	59	90
2R	11447601	62	0	408	0	470
2R	11447607	15	0	489	1	505
2R	11447617	64	1	420	0	485
2R	11447623	108	0	394	0	502
2R	11447933	573	0	0	0	573
2R	11447935	521	0	45	0	566
2R	11447987	399	1	235	0	635
2R	11450317	280	0	281	0	561
2R	11450318	289	0	287	0	576
2R	11603464	0	0	0	1	1
2R	11635584	0	0	0	0	0
2R	11635585	0	0	0	0	0
2R	11635587	0	0	0	0	0
2R	11635588	0	0	0	0	0
2R	11671280	0	0	0	2	2
2R	11779856	0	0	0	0	0
2R	11827392	0	0	0	11	11
2R	11845525	45	0	9	0	54
2R	11893047	7	0	0	0	7
2R	11990709	33	0	2	0	35
2R	12024356	0	2	0	1	3
2R	12025551	0	5	0	0	5
2R	12025588	0	3	0	0	3
2R	12265428	4	0	0	0	4
2R	12269039	10	0	2	0	12
2R	12328060	50	0	0	0	50
2R	12328068	49	0	0	0	49
2R	12328073	50	0	0	0	50
2R	12329738	0	0	0	0	0
2R	12350262	2	0	0	0	2
2R	12448654	113	0	41	0	154
2R	12448686	89	0	94	0	183
2R	12448723	144	0	68	0	212
2R	12448779	91	0	112	0	203
2R	12469039	11	0	0	0	11
2R	12470834	16	0	0	0	16
2R	12489327	0	0	0	102	102
2R	12648195	0	0	0	6	6
2R	12754897	0	2	0	0	2
2R	12758582	63	0	93	0	156
2R	12800608	10	0	37	0	47
2R	12800859	40	0	9	0	49
2R	12921246	211	0	211	0	422
2R	12921325	286	0	202	0	488
2R	12921326	379	0	108	0	487
2R	13437401	0	0	0	15	15
2R	13517261	0	23	0	149	172
2R	13517274	0	71	0	86	157
2R	13517275	0	131	0	22	153
2R	13517347	0	42	0	105	147
2R	13580366	4	0	0	0	4
2R	13747628	4	0	37	0	41
2R	13748897	0	0	45	1	46
2R	13809071	46	0	4	0	50
2R	13809547	31	0	118	0	149
2R	13809607	96	0	62	0	158
2R	13809962	133	0	126	0	259
2R	13810199	110	0	80	0	190
2R	13817109	171	1	54	0	226
2R	13817124	183	2	13	0	198
2R	13817379	37	0	227	0	264
2R	13823895	0	0	0	99	99
2R	13846257	1	0	0	0	1
2R	13858942	0	0	0	0	0
2R	13885952	0	1	0	131	132
2R	13886458	0	11	0	92	103
2R	13887556	0	58	0	38	96
2R	13893580	0	13	0	62	75
2R	13893934	0	58	0	19	77
2R	13916837	0	0	0	1	1
2R	13974052	0	0	0	55	55
2R	14062507	0	19	0	83	102
2R	14062651	0	48	0	50	98
2R	14062768	0	39	0	80	119
2R	14062771	0	64	0	54	118
2R	14062774	0	17	0	101	118
2R	14149035	0	0	0	86	86
2R	14152423	0	5	0	0	5
2R	14153104	0	2	0	0	2
2R	14171351	21	0	0	0	21
2R	14172781	218	0	44	0	262
2R	14178731	180	0	29	0	209
2R	14182106	86	0	18	0	104
2R	14215739	0	1	0	0	1
2R	14297994	347	1	79	0	427
2R	14331618	1	0	0	0	1
2R	14334547	0	0	0	0	0
2R	14355520	22	0	7	0	29
2R	14361978	3	6	0	0	9
2R	14507629	62	0	0	0	62
2R	14538499	0	0	0	0	0
2R	14555183	0	0	0	0	0
2R	14740426	0	31	0	248	279
2R	14741592	0	208	0	125	333
2R	14742174	0	30	0	392	422
2R	14742210	0	146	0	277	423
2R	14742223	0	100	1	286	387
2R	14742241	0	153	0	247	400
2R	14742359	0	0	0	405	405
2R	14756598	332	0	0	0	332
2R	14762018	0	120	0	147	267
2R	14971913	0	0	110	0	110
2R	15264046	0	47	0	40	87
2R	15264051	0	34	0	52	86
2R	15264096	0	70	0	24	94
2R	15264743	0	37	0	61	98
2R	15415679	38	0	1	0	39
2R	15456269	9	0	7	0	16
2R	15460575	17	0	4	0	21
2R	15460578	15	0	5	0	20
2R	15516140	0	3	0	79	82
2R	15518712	0	60	1	99	160
2R	15765728	0	1	0	33	34
2R	15766457	0	0	0	27	27
2R	15772754	0	0	0	1	1
2R	15772755	0	0	0	1	1
2R	15775053	1	4	0	43	48
2R	15777061	0	6	0	4	10
2R	15779915	0	0	0	0	0
2R	15779918	0	0	0	0	0
2R	15779987	0	0	0	0	0
2R	15779998	0	0	0	0	0
2R	15786556	0	0	0	0	0
2R	15809225	0	0	0	2	2
2R	15871835	0	68	0	41	109
2R	15872366	0	117	0	40	157
2R	15980167	0	1	0	14	15
2R	16336488	6	0	1	0	7
2R	16432544	10	0	0	0	10
2R	16534056	0	0	0	0	0
2R	16576409	0	233	0	0	233
2R	16647491	80	0	11	0	91
2R	16647492	17	0	74	0	91
2R	16647565	74	0	16	0	90
2R	16647597	86	0	13	0	99
2R	16647631	22	0	77	0	99
2R	16650664	59	0	0	0	59
2R	16650669	61	0	0	0	61
2R	16650728	68	0	0	0	68
2R	16650742	68	0	0	0	68
2R	16650776	47	0	15	0	62
2R	16650779	55	0	6	0	61
2R	16650790	37	0	32	0	69
2R	16650805	53	0	14	0	67
2R	16650890	57	0	4	0	61
2R	16762451	0	0	0	2	2
2R	16765101	0	0	0	27	27
2R	16917584	1	0	0	0	1
2R	16932924	23	0	0	0	23
2R	17222715	0	0	0	0	0
2R	17364649	19	0	6	0	25
2R	17374869	37	0	61	0	98
2R	17375028	87	0	42	0	129
2R	17375029	109	0	22	0	131
2R	17375057	51	0	74	0	125
2R	17375058	73	0	48	1	122
2R	17377109	34	1	165	0	200
2R	17377110	40	0	151	0	191
2R	17377122	62	0	140	0	202
2R	17377125	117	0	80	0	197
2R	17377403	127	0	48	0	175
2R	17701194	0	0	0	1	1
2R	18020907	0	0	0	0	0
2R	18134284	0	0	0	12	12
2R	18145289	9	0	0	0	9
2R	18167781	154	0	0	0	154
2R	18173890	43	0	0	0	43
2R	18281192	0	0	0	89	89
2R	18356868	0	5	0	18	23
2R	18518047	5	0	3	0	8
2R	18518048	3	0	6	0	9
2R	18720854	0	0	0	0	0
2R	18743376	0	0	0	2	2
2R	18865057	0	0	0	0	0
2R	18998450	16	0	3	0	19
2R	19006082	79	0	64	0	143
2R	19006586	1	0	0	0	1
2R	19138221	0	0	0	2	2
2R	19139754	131	0	0	0	131
2R	19179174	21	0	4	0	25
2R	19223379	65	0	19	0	84
2R	19223636	66	0	58	0	124
2R	19225658	128	0	50	0	178
2R	19303685	50	0	20	0	70
2R	19326309	0	32	0	23	55
2R	19525936	0	0	0	45	45
2R	19566903	0	4	0	25	29
2R	19625834	0	0	0	0	0
2R	19727230	0	0	0	0	0
2R	20424540	74	0	0	0	74
2R	20658504	0	0	14	0	14
2R	21145178	488	1	39	0	528
2R	21315686	66	0	37	0	103
2R	21334960	8	0	21	0	29
2R	21480214	0	11	0	78	89
2R	21557174	12	0	60	0	72
2R	21620849	0	32	0	48	80
2R	21621075	0	26	0	23	49
2R	21653466	55	0	97	0	152
2R	21851363	0	0	0	0	0
2R	22175545	31	0	0	0	31
2R	22227209	0	0	0	47	47
2R	22391510	34	0	111	0	145
2R	22564373	0	31	0	59	90
2R	22564377	0	33	0	56	89
2R	22568445	0	0	0	0	0
2R	22573070	0	0	0	0	0
2R	22587796	0	0	0	0	0
2R	22637905	68	0	0	0	68
2R	22673075	27	0	0	0	27
2R	22746263	0	1	0	6	7
2R	23381950	0	0	0	57	57
2R	23598132	22	0	5	0	27
2R	23804970	0	0	0	0	0
2R	23838782	43	0	4	0	47
2R	23844274	0	0	0	66	66
2R	23867196	0	0	0	254	254
2R	24006102	0	1	0	88	89
2R	24006115	0	0	0	83	83
2R	24006555	0	91	0	10	101
2R	24046125	0	1	0	1	2
2R	24050977	39	0	28	0	67
2R	24051555	74	0	14	0	88
2R	24218949	0	0	0	0	0
2R	24332337	0	0	0	0	0
2R	24384812	0	86	0	7	93
2R	24419247	0	180	0	25	205
2R	24419250	0	177	0	29	206
2R	24500965	0	0	0	1	1
2R	24512318	0	38	0	94	132
2R	24882682	131	0	21	0	152
2R	24882751	105	1	50	0	156
2R	24885850	111	0	28	0	139
2R	24904717	172	0	33	0	205
2R	24910398	214	0	146	0	360
2R	24910568	168	0	90	0	258
2R	24910752	151	0	44	0	195
2R	24910775	44	0	155	0	199
2R	24910814	137	0	108	0	245
2R	24910823	117	0	145	0	262
2R	24911061	95	0	116	0	211
2R	24911109	96	0	147	0	243
2R	24912004	132	0	36	0	168
2R	24912848	37	0	261	0	298
2R	24912923	307	0	0	0	307
2R	24914689	204	0	41	0	245
2R	24914702	74	0	166	0	240
2R	24914794	64	0	121	0	185
2R	24914829	166	0	21	0	187
2R	24914858	22	0	189	0	211
2R	24914859	200	0	17	0	217
2R	24914864	45	0	178	0	223
2R	24914865	68	1	155	0	224
2R	24914874	88	0	144	0	232
2R	24919093	260	0	25	0	285
2R	24920153	151	0	8	0	159
2R	24995597	0	42	0	72	114
2R	24995857	0	74	0	68	142
2R	25255069	52	0	10	0	62
2R	25255079	31	0	33	0	64
2R	25255082	25	0	39	0	64
2R	25255913	84	0	13	0	97
2R	25256658	30	0	36	0	66
2R	25257110	45	0	8	0	53
2R	25257267	38	0	49	0	87
2R	25257297	63	0	30	0	93
2R	25257312	23	0	67	0	90
2R	25257313	12	0	81	0	93
2R	25257314	32	0	62	0	94
2R	25257317	57	0	34	0	91
2R	25257328	64	0	32	0	96
2R	25257336	94	0	7	0	101
2R	25257337	84	0	11	0	95
2R	25257342	8	0	93	0	101
2R	25257343	8	0	91	0	99
2R	25257375	101	0	0	0	101
2R	25257376	89	0	12	0	101
2R	25257377	52	0	49	0	101
2R	25257383	51	0	54	0	105
2R	25257388	59	0	47	0	106
2R	25257391	68	0	40	0	108
2R	25257392	90	0	23	0	113
2R	25257393	100	0	10	0	110
2R	25257394	65	0	41	0	106
2R	25257396	111	0	2	0	113
2R	25257397	90	0	23	0	113
2R	25257398	90	0	17	0	107
2R	25257404	37	0	66	0	103
2R	25257405	23	0	81	0	104
2R	25257406	52	0	54	0	106
2R	25257414	94	0	14	0	108
2R	25257417	59	0	50	0	109
2R	25257418	55	0	53	0	108
2R	25257420	100	0	12	0	112
2R	25257424	103	0	17	0	120
2R	25257425	28	0	88	0	116
2R	25257426	18	0	100	0	118
2R	25257427	76	0	40	0	116
2R	25257431	110	0	15	0	125
2R	25257439	103	0	20	0	123
2R	25257445	75	0	41	0	116
2R	25257451	44	0	65	0	109
2R	25257453	99	0	11	0	110
2R	25257483	88	0	29	0	117
2R	25257508	63	0	64	0	127
2R	25257625	76	0	9	0	85
2R	25257632	85	0	4	0	89
2R	25257633	84	0	1	0	85
2R	25257638	90	0	0	0	90
2R	25257643	58	0	31	0	89
2R	25257682	24	0	45	0	69
2R	25257683	38	0	33	0	71
2R	25257699	48	0	5	0	53
2R	25257701	37	0	16	0	53
2R	25257703	19	0	38	0	57
2R	25257714	39	0	19	0	58
2R	25257732	28	0	30	0	58
2R	25257735	31	0	28	0	59
2R	25257740	29	0	32	0	61
2R	25257741	43	0	15	0	58
2R	25257743	47	0	12	0	59
2R	25257781	35	0	19	0	54
2R	25257788	54	0	1	0	55
2R	25257789	54	0	0	0	54
2R	25257792	43	0	9	0	52
2R	25257806	18	0	19	0	37
2R	25257812	28	0	6	0	34
2R	25257820	28	0	6	0	34
2R	25257832	17	0	15	0	32
2R	25257836	10	0	22	0	32
2R	25257964	5	0	25	0	30
3L	71000	0	0	0	0	0
3L	214328	0	33	0	0	33
3L	226141	2795	0	185	1	2981
3L	271201	0	0	1	0	1
3L	336697	1	0	0	0	1
3L	346424	1	0	0	0	1
3L	346882	0	0	0	8	8
3L	411895	0	0	0	0	0
3L	462074	0	0	0	0	0
3L	498116	0	0	0	0	0
3L	546751	0	0	0	0	0
3L	575217	96	0	0	0	96
3L	598790	9	0	10	0	19
3L	991441	103	0	47	0	150
3L	1010857	0	0	0	0	0
3L	1011246	0	0	0	0	0
3L	1011285	0	0	0	0	0
3L	1026639	0	12	0	91	103
3L	1027109	0	48	0	88	136
3L	1033059	0	0	0	2	2
3L	1034384	0	4	0	3	7
3L	1034386	0	2	0	5	7
3L	1044064	1	0	0	0	1
3L	1046651	0	0	0	2	2
3L	1135014	1	0	0	0	1
3L	1138357	0	0	0	0	0
3L	1210848	1	0	0	0	1
3L	1217228	0	0	0	0	0
3L	1227904	0	0	0	0	0
3L	1230644	0	0	58	0	58
3L	1318745	0	1	0	0	1
3L	1407143	0	0	0	0	0
3L	1490348	0	2	0	7	9
3L	1526045	0	0	0	13	13
3L	1556299	0	0	0	230	230
3L	1689558	39	0	0	0	39
3L	1727806	0	0	0	0	0
3L	1782670	1	291	1	224	517
3L	1945203	0	0	0	4	4
3L	2001719	0	0	0	0	0
3L	2039782	0	5	0	46	51
3L	2039908	0	17	0	78	95
3L	2039918	0	38	0	59	97
3L	2039919	0	6	0	95	101
3L	2042849	0	0	0	125	125
3L	2043519	0	0	0	138	138
3L	2044551	0	0	0	135	135
3L	2044916	0	1	0	111	112
3L	2045959	0	0	0	118	118
3L	2051548	0	0	0	62	62
3L	2054348	0	0	0	9	9
3L	2055902	0	0	0	14	14
3L	2056964	0	0	0	15	15
3L	2060460	0	0	0	8	8
3L	2074107	0	0	0	28	28
3L	2080672	0	33	0	0	33
3L	2080891	0	27	0	0	27
3L	2089039	0	0	0	18	18
3L	2096769	0	119	0	0	119
3L	2125496	0	1	0	216	217
3L	2126093	0	34	0	191	225
3L	2134649	0	2	0	89	91
3L	2135049	0	0	0	149	149
3L	2190111	0	0	0	93	93
3L	2245947	0	0	0	0	0
3L	2251644	0	0	0	0	0
3L	2348350	0	0	0	0	0
3L	2372937	0	0	29	0	29
3L	2377732	0	0	0	7	7
3L	2390472	0	0	0	0	0
3L	2424958	0	0	0	0	0
3L	2440451	0	0	0	0	0
3L	2458238	25	0	0	0	25
3L	2469405	0	0	0	0	0
3L	2469912	0	0	0	0	0
3L	2473344	0	0	0	0	0
3L	2481805	7	0	0	0	7
3L	2498728	0	0	0	113	113
3L	2499964	0	0	1	1353	1354
3L	2519293	0	0	0	0	0
3L	2578670	0	0	0	0	0
3L	2657532	0	0	0	126	126
3L	2665990	0	26	0	57	83
3L	2666151	0	71	0	6	77
3L	2773256	0	0	0	68	68
3L	2773526	0	0	0	50	50
3L	2777176	62	0	0	0	62
3L	2778433	40	0	0	0	40
3L	2778439	47	0	0	0	47
3L	2784069	0	25	0	0	25
3L	2784359	0	0	15	0	15
3L	2785524	0	0	20	0	20
3L	2785531	0	0	0	18	18
3L	2785536	0	0	0	16	16
3L	2785542	0	19	0	0	19
3L	2785610	0	13	0	0	13
3L	2785621	0	0	0	13	13
3L	2785658	13	0	0	0	13
3L	2786034	0	0	0	0	0
3L	2791593	0	0	0	73	73
3L	2799685	0	0	0	0	0
3L	2882059	0	0	0	0	0
3L	2924789	222	1	14	0	237
3L	2924790	221	0	19	0	240
3L	2924829	179	0	58	0	237
3L	2925090	65	0	121	0	186
3L	2925255	22	0	173	0	195
3L	2925550	66	0	0	0	66
3L	2939953	97	0	54	0	151
3L	2940825	218	0	10	0	228
3L	2940919	174	0	41	0	215
3L	2941131	39	0	189	0	228
3L	2941132	9	0	214	0	223
3L	2941311	173	0	19	0	192
3L	2941312	16	0	176	0	192
3L	2941364	14	1	174	0	189
3L	2941396	42	0	140	0	182
3L	2941425	69	0	130	0	199
3L	2941426	7	0	194	0	201
3L	2961305	0	0	0	0	0
3L	3086223	222	0	51	0	273
3L	3114961	0	0	0	82	82
3L	3150180	0	0	0	0	0
3L	3226015	13	0	10	0	23
3L	3311439	0	3	0	0	3
3L	3359345	56	0	61	0	117
3L	3361215	0	139	0	0	139
3L	3371858	0	79	0	45	124
3L	3371901	0	51	0	78	129
3L	3371976	0	38	0	139	177
3L	3407053	0	0	0	0	0
3L	3442381	0	0	0	2	2
3L	3471786	0	0	0	89	89
3L	3555912	1	0	0	0	1
3L	3729820	0	0	0	0	0
3L	3761976	0	0	0	8	8
3L	3762337	0	0	0	3	3
3L	3781259	0	0	1	47	48
3L	3786975	0	0	0	0	0
3L	3815844	0	0	0	0	0
3L	3837134	0	0	153	0	153
3L	3892642	0	0	70	1	71
3L	3904309	3	0	0	0	3
3L	3988087	100	0	13	0	113
3L	4089220	0	0	0	2	2
3L	4092326	715	0	8	1	724
3L	4172458	51	0	0	0	51
3L	4198341	26	0	31	0	57
3L	4264563	0	0	0	0	0
3L	4307932	0	0	0	0	0
3L	4308806	0	0	0	0	0
3L	4314575	0	0	0	0	0
3L	4314576	0	0	0	0	0
3L	4314586	0	0	0	0	0
3L	4316475	0	0	2	0	2
3L	4317484	0	2	0	0	2
3L	4317522	0	0	0	0	0
3L	4317524	0	0	0	0	0
3L	4317564	0	0	2	0	2
3L	4318105	0	0	0	0	0
3L	4318481	0	0	0	0	0
3L	4369162	0	334	0	128	462
3L	4369184	0	334	0	99	433
3L	4369185	1	198	0	239	438
3L	4369207	0	41	0	469	510
3L	4369208	0	36	0	470	506
3L	4369213	0	35	0	481	516
3L	4369313	0	0	0	528	528
3L	4369422	0	116	0	246	362
3L	4369445	0	31	0	301	332
3L	4369455	0	31	0	341	372
3L	4369459	0	35	0	325	360
3L	4429963	20	0	304	0	324
3L	4429967	186	0	143	0	329
3L	4430199	112	1	40	1	154
3L	4430208	17	0	160	0	177
3L	4431761	19	0	214	0	233
3L	4432486	161	1	182	0	344
3L	4432487	69	0	274	0	343
3L	4433319	304	0	172	0	476
3L	4433320	44	0	428	0	472
3L	4446288	0	0	0	0	0
3L	4584256	18	0	94	0	112
3L	4585849	105	0	69	0	174
3L	4585851	143	0	29	0	172
3L	4585858	111	0	66	0	177
3L	4585859	21	0	150	0	171
3L	4585865	105	0	64	0	169
3L	4586039	118	0	12	0	130
3L	4586053	73	0	56	0	129
3L	4586714	428	0	102	0	530
3L	4586715	70	0	441	0	511
3L	4590437	210	0	60	0	270
3L	4590448	215	0	65	0	280
3L	4590461	261	0	30	0	291
3L	4590463	272	0	19	0	291
3L	4590484	292	0	32	0	324
3L	4590685	127	0	179	0	306
3L	4590708	236	0	100	0	336
3L	4590709	60	0	275	0	335
3L	4591116	116	0	173	0	289
3L	4591123	257	0	31	0	288
3L	4591132	258	0	47	0	305
3L	4591179	318	0	42	1	361
3L	4591222	344	0	47	0	391
3L	4591226	393	0	12	0	405
3L	4591259	324	0	37	0	361
3L	4591369	281	0	30	0	311
3L	4591744	287	0	10	0	297
3L	4732441	0	0	0	0	0
3L	4811851	0	0	3	0	3
3L	4822418	88	0	0	0	88
3L	4822420	85	0	0	0	85
3L	4867777	0	0	0	0	0
3L	4897294	0	0	0	0	0
3L	4985909	0	0	0	1	1
3L	4986257	0	0	0	0	0
3L	4986611	0	0	0	0	0
3L	4986891	0	0	0	0	0
3L	5045427	0	0	0	0	0
3L	5102529	0	0	0	0	0
3L	5116849	0	0	0	0	0
3L	5133159	9	0	0	0	9
3L	5133686	0	0	0	0	0
3L	5135062	75	0	0	0	75
3L	5135116	81	0	0	0	81
3L	5139737	50	0	0	0	50
3L	5144164	23	0	0	0	23
3L	5157874	0	22	0	228	250
3L	5160640	0	2	0	134	136
3L	5171594	0	0	0	0	0
3L	5171618	1	0	0	0	1
3L	5185014	0	0	0	0	0
3L	5188016	0	0	0	3	3
3L	5191766	0	0	0	0	0
3L	5192055	2	0	0	0	2
3L	5212866	3	0	0	0	3
3L	5212915	0	4	0	0	4
3L	5212920	0	4	0	0	4
3L	5213133	0	0	0	1	1
3L	5213134	1	0	0	0	1
3L	5247676	0	0	0	18	18
3L	5334897	0	0	0	0	0
3L	5347418	0	0	0	0	0
3L	5435357	0	0	1	0	1
3L	5664597	1	0	0	0	1
3L	5692734	5	0	1	0	6
3L	5696130	14	0	25	0	39
3L	5740525	49	1	68	0	118
3L	5743791	9	0	0	0	9
3L	5745060	65	0	14	0	79
3L	5746701	446	0	1	0	447
3L	5746708	417	0	35	0	452
3L	5746772	366	1	78	0	445
3L	5750034	0	0	0	3	3
3L	5764525	0	1	0	154	155
3L	5815976	0	0	14	0	14
3L	6008890	0	0	0	0	0
3L	6008957	0	0	0	0	0
3L	6009017	0	0	0	0	0
3L	6062381	0	0	0	1	1
3L	6193542	19	0	0	0	19
3L	6285897	0	0	0	0	0
3L	6331348	30	0	0	0	30
3L	6459287	0	0	0	0	0
3L	6506202	0	0	0	0	0
3L	6506212	0	0	0	0	0
3L	6534871	0	0	0	0	0
3L	6641116	0	0	0	0	0
3L	6643565	0	0	0	0	0
3L	6643648	0	0	0	0	0
3L	6643649	0	0	0	0	0
3L	6643749	0	0	0	0	0
3L	6643752	0	0	0	0	0
3L	6689091	0	0	0	0	0
3L	6689204	0	0	0	0	0
3L	6694843	0	0	0	0	0
3L	6734513	69	0	0	0	69
3L	6754914	0	0	0	31	31
3L	6769182	0	0	0	0	0
3L	6786307	0	0	1	0	1
3L	6800394	0	0	1	0	1
3L	6800402	0	0	0	1	1
3L	6949680	0	78	0	520	598
3L	6949683	0	38	0	565	603
3L	6949688	0	119	1	504	624
3L	6949690	0	117	1	506	624
3L	6950110	0	254	1	513	768
3L	6950168	0	68	0	1036	1104
3L	6954754	0	609	0	789	1398
3L	7021467	0	0	0	0	0
3L	7059577	0	0	0	31	31
3L	7180438	0	50	0	58	108
3L	7218079	0	0	0	0	0
3L	7235679	0	0	0	0	0
3L	7236912	0	0	0	0	0
3L	7324105	0	0	0	24	24
3L	7326096	18	0	0	0	18
3L	7417841	0	0	0	0	0
3L	7650269	0	0	0	0	0
3L	7654672	0	14	0	49	63
3L	7665256	783	0	0	0	783
3L	7666636	0	35	0	22	57
3L	7694236	0	0	0	0	0
3L	7696248	0	0	0	6	6
3L	7830703	0	24	0	29	53
3L	7923214	0	0	0	0	0
3L	7928680	0	101	0	44	145
3L	7939905	0	0	0	0	0
3L	7960324	0	0	0	0	0
3L	7979842	0	0	0	0	0
3L	8041599	0	0	0	0	0
3L	8066395	0	0	0	3	3
3L	8120375	0	0	103	0	103
3L	8120519	0	0	102	0	102
3L	8121502	10	0	0	0	10
3L	8126738	0	0	50	0	50
3L	8126864	40	0	0	0	40
3L	8184846	0	0	38	0	38
3L	8185142	0	0	0	0	0
3L	8228580	0	0	0	0	0
3L	8375374	0	0	0	0	0
3L	8434395	0	0	0	160	160
3L	8444869	0	5	0	0	5
3L	8492631	0	0	0	0	0
3L	8532834	0	0	0	64	64
3L	8532845	0	61	0	0	61
3L	8588267	0	0	224	0	224
3L	8588835	3	0	0	0	3
3L	8589446	5	0	0	0	5
3L	8597507	436	0	2	0	438
3L	8648332	12230	2	1	1	12234
3L	8678627	0	1	117	0	118
3L	8678628	0	0	112	0	112
3L	8678673	1	0	139	0	140
3L	8719077	0	0	14	0	14
3L	8724069	0	0	12	0	12
3L	8736015	0	0	0	4	4
3L	8740095	0	23	1	439	463
3L	8759599	0	0	21	0	21
3L	8775212	0	0	1	0	1
3L	8786152	0	0	79	0	79
3L	8798415	0	0	68	0	68
3L	8827752	0	0	55	0	55
3L	8839904	0	0	1	0	1
3L	8844956	0	0	0	0	0
3L	8850667	0	0	0	0	0
3L	8885355	0	0	0	0	0
3L	8892723	0	0	1	0	1
3L	8913159	0	0	0	0	0
3L	8913856	0	0	0	0	0
3L	8913897	0	0	0	0	0
3L	8931961	37	0	0	0	37
3L	8940166	89	0	0	0	89
3L	8983591	0	266	0	0	266
3L	8985580	0	18	0	0	18
3L	8987752	0	0	0	112	112
3L	8991591	0	50	0	0	50
3L	8993217	0	43	0	0	43
3L	8997822	0	25	0	0	25
3L	9100899	0	4	0	49	53
3L	9124178	0	4	0	2	6
3L	9124180	0	0	0	6	6
3L	9124570	0	5	0	5	10
3L	9144950	276	0	0	0	276
3L	9146324	132	0	0	0	132
3L	9147825	0	1	0	58	59
3L	9149081	0	0	0	105	105
3L	9151835	0	28	1	128	157
3L	9151836	0	9	0	149	158
3L	9155185	0	35	0	109	144
3L	9155218	0	151	0	5	156
3L	9161860	0	3	0	14	17
3L	9161861	0	4	0	14	18
3L	9161863	0	4	0	16	20
3L	9161864	0	2	0	19	21
3L	9161865	0	1	0	17	18
3L	9162917	1	68	0	78	147
3L	9162924	0	19	0	110	129
3L	9172898	0	0	2	0	2
3L	9258715	9	0	0	0	9
3L	9263686	0	2	0	0	2
3L	9270392	0	0	62	0	62
3L	9282077	7	0	0	0	7
3L	9287571	0	0	0	39	39
3L	9341681	11	0	0	0	11
3L	9378596	0	0	0	55	55
3L	9488590	0	0	0	1	1
3L	9497783	0	0	0	4	4
3L	9562249	0	0	0	0	0
3L	9566820	0	0	0	0	0
3L	9566821	0	0	0	0	0
3L	9587305	15	0	0	0	15
3L	9608849	0	0	0	0	0
3L	9622044	0	0	28	0	28
3L	9625888	0	0	11	0	11
3L	9631909	0	53	0	0	53
3L	9632368	0	164	0	0	164
3L	9633307	0	184	0	1	185
3L	9644938	32	0	0	0	32
3L	9645414	0	0	0	32	32
3L	9648209	0	0	0	0	0
3L	9649368	0	2	0	0	2
3L	9666680	0	1	0	0	1
3L	9668976	0	70	0	40	110
3L	9682712	0	0	1	0	1
3L	9682988	0	0	0	0	0
3L	9686533	0	0	0	57	57
3L	9688751	0	0	0	44	44
3L	9709045	1	0	151	0	152
3L	9717933	0	0	0	5	5
3L	9724380	0	0	0	8	8
3L	9724514	0	8	0	0	8
3L	9724607	11	0	0	0	11
3L	9730982	1471	0	0	0	1471
3L	9734333	0	0	0	209	209
3L	9736382	0	0	0	18	18
3L	9736627	0	0	0	0	0
3L	9738180	0	0	0	344	344
3L	9740249	0	0	0	10	10
3L	9740401	0	9	0	0	9
3L	9774568	1	0	0	0	1
3L	9799424	0	0	1	0	1
3L	9807026	0	0	2	0	2
3L	9814841	0	3	0	0	3
3L	9815342	0	0	1	0	1
3L	9816197	0	0	2	0	2
3L	9816249	0	2	0	0	2
3L	9816250	0	0	2	0	2
3L	9816252	0	0	2	0	2
3L	9816265	49	0	0	0	49
3L	9816267	0	0	51	0	51
3L	9817489	0	0	0	0	0
3L	9819018	0	0	0	0	0
3L	9821256	0	0	0	0	0
3L	9821464	0	1	0	0	1
3L	9821472	1	0	0	0	1
3L	9821474	1	0	0	0	1
3L	9821481	0	0	0	1	1
3L	9821685	0	0	0	5	5
3L	9833291	344	0	27	0	371
3L	9833294	269	0	113	0	382
3L	9833300	216	0	176	1	393
3L	9833301	143	0	239	0	382
3L	9833364	298	0	21	0	319
3L	9833369	72	0	259	0	331
3L	9833370	307	0	27	0	334
3L	9833459	219	0	125	0	344
3L	9833484	277	0	52	0	329
3L	9833487	322	0	11	0	333
3L	9867222	107	0	15	0	122
3L	9867339	91	0	136	0	227
3L	9885244	0	17	0	0	17
3L	9885764	0	0	0	10	10
3L	9886836	0	0	0	13	13
3L	9892134	25	0	29	0	54
3L	9943795	0	0	0	0	0
3L	9943907	0	0	0	0	0
3L	9972754	4	0	0	0	4
3L	9974737	13	0	0	0	13
3L	10023375	1	0	0	0	1
3L	10153722	0	0	0	2	2
3L	10182898	0	2	0	2	4
3L	10182954	0	2	0	3	5
3L	10185757	0	0	0	5	5
3L	10197944	0	0	0	0	0
3L	10287759	0	0	1	0	1
3L	10358012	0	0	0	0	0
3L	10423429	0	0	0	0	0
3L	10478991	0	0	0	0	0
3L	10516387	9	0	6	0	15
3L	10556226	0	0	3	0	3
3L	10583448	0	16	0	0	16
3L	10644076	0	0	45	0	45
3L	10659046	0	0	0	0	0
3L	10672257	0	0	0	0	0
3L	10785536	0	0	0	0	0
3L	10787010	0	0	0	0	0
3L	10787012	0	0	0	0	0
3L	10820249	0	0	0	0	0
3L	10848012	0	0	0	0	0
3L	10944093	0	0	0	0	0
3L	11038040	0	4	0	160	164
3L	11067981	32	0	0	0	32
3L	11073860	0	0	0	116	116
3L	11166174	0	13	0	0	13
3L	11166793	14	0	0	0	14
3L	11166799	0	0	0	13	13
3L	11166802	0	0	0	12	12
3L	11166932	0	0	0	25	25
3L	11175776	2	0	1	0	3
3L	11175795	5	0	2	0	7
3L	11175891	5	0	0	0	5
3L	11175895	5	0	0	0	5
3L	11175896	4	0	0	0	4
3L	11176183	2	0	0	0	2
3L	11176185	2	0	0	0	2
3L	11178469	0	0	143	0	143
3L	11203066	0	0	0	27	27
3L	11209891	0	0	33	0	33
3L	11211185	51	0	0	0	51
3L	11211200	43	0	0	0	43
3L	11218031	0	0	0	0	0
3L	11218035	0	0	0	0	0
3L	11218227	0	0	0	0	0
3L	11225111	127	0	0	0	127
3L	11225150	71	0	46	0	117
3L	11280036	0	0	0	0	0
3L	11519814	0	10	0	0	10
3L	11552592	0	0	0	7	7
3L	11553320	0	2	0	1	3
3L	11553330	0	2	0	1	3
3L	11553333	0	1	0	2	3
3L	11559570	0	0	0	0	0
3L	11599583	1	0	0	0	1
3L	11650023	0	0	0	90	90
3L	11670833	0	0	0	0	0
3L	11734662	0	0	0	91	91
3L	11746631	0	0	0	0	0
3L	11764981	0	0	0	0	0
3L	11803246	0	0	0	0	0
3L	11807770	0	0	0	0	0
3L	11815790	0	15	0	0	15
3L	11824846	18	0	0	0	18
3L	11827577	0	0	0	9	9
3L	11837250	0	0	0	0	0
3L	11837265	0	0	0	0	0
3L	11857720	0	0	0	0	0
3L	11857797	1	0	0	0	1
3L	11857887	0	0	1	0	1
3L	11857906	0	0	1	0	1
3L	11956759	0	0	0	0	0
3L	11964188	0	3	0	0	3
3L	11974542	0	0	0	0	0
3L	12022418	0	0	0	0	0
3L	12023402	0	1	0	0	1
3L	12066158	0	0	0	0	0
3L	12070965	0	34	0	0	34
3L	12100697	0	0	0	0	0
3L	12105494	0	0	0	0	0
3L	12123225	1	1	0	736	738
3L	12211671	0	76	0	47	123
3L	12211756	0	20	1	87	108
3L	12212148	0	84	0	4	88
3L	12212309	0	115	0	3	118
3L	12239964	0	0	0	0	0
3L	12244780	0	0	1	0	1
3L	12252166	0	0	0	0	0
3L	12297495	0	0	0	0	0
3L	12423647	0	0	0	0	0
3L	12426521	0	0	0	1	1
3L	12430208	0	0	0	0	0
3L	12440786	0	0	0	0	0
3L	12445033	0	0	0	0	0
3L	12463065	0	0	0	7	7
3L	12463742	0	0	14	0	14
3L	12471180	0	0	0	0	0
3L	12471570	0	0	0	0	0
3L	12493418	0	0	4	0	4
3L	12494398	2	0	0	0	2
3L	12508254	3	0	0	0	3
3L	12508840	0	1	0	0	1
3L	12509140	0	0	0	1	1
3L	12510503	2	0	0	0	2
3L	12519462	155	0	0	0	155
3L	12519598	202	0	0	0	202
3L	12524172	1	0	0	0	1
3L	12527022	0	0	1	0	1
3L	12529862	0	0	0	1	1
3L	12546839	0	0	0	1	1
3L	12691864	0	0	0	0	0
3L	12731393	0	0	0	0	0
3L	12731797	0	0	0	0	0
3L	12768257	27	0	0	0	27
3L	12826688	0	5	0	0	5
3L	12853773	0	0	112	0	112
3L	12856591	50	0	28	0	78
3L	13007953	0	1	0	0	1
3L	13020448	0	25	0	176	201
3L	13038438	25	0	49	0	74
3L	13194742	0	0	0	0	0
3L	13194835	0	0	0	0	0
3L	13195237	0	0	0	0	0
3L	13195308	0	0	0	0	0
3L	13196156	0	0	0	0	0
3L	13196212	0	0	0	0	0
3L	13218792	0	0	0	0	0
3L	13225212	0	0	0	0	0
3L	13309717	0	0	0	0	0
3L	13312105	0	0	0	0	0
3L	13312111	0	0	0	0	0
3L	13418107	0	2	0	3	5
3L	13435185	0	8	0	10	18
3L	13467599	0	95	0	0	95
3L	13467636	0	100	0	0	100
3L	13467653	0	99	0	0	99
3L	13480590	0	0	54	0	54
3L	13492027	0	0	0	2	2
3L	13494294	6	0	0	0	6
3L	13494298	6	0	0	0	6
3L	13494304	5	0	0	0	5
3L	13494305	0	0	5	0	5
3L	13494355	0	0	0	5	5
3L	13494364	5	0	0	0	5
3L	13494365	0	0	5	0	5
3L	13494372	0	4	0	0	4
3L	13494373	0	5	0	0	5
3L	13494374	5	0	0	0	5
3L	13494390	0	0	6	0	6
3L	13494392	0	5	0	0	5
3L	13494408	0	4	0	0	4
3L	13494438	4	0	0	0	4
3L	13494439	0	3	0	0	3
3L	13494441	3	0	0	0	3
3L	13494445	3	0	0	0	3
3L	13494448	3	0	0	0	3
3L	13494451	0	0	0	0	0
3L	13494457	0	0	1	0	1
3L	13494472	0	0	0	1	1
3L	13494497	2	0	0	0	2
3L	13494498	1	0	0	0	1
3L	13494519	0	2	0	0	2
3L	13494520	0	0	0	2	2
3L	13494596	0	0	2	0	2
3L	13494693	2	0	0	0	2
3L	13494842	0	0	19	0	19
3L	13502410	0	0	0	9	9
3L	13535416	16	0	33	0	49
3L	13600286	0	0	0	0	0
3L	13703883	1	0	0	0	1
3L	13858574	33	0	15	0	48
3L	13859907	13	0	0	0	13
3L	13869566	72	0	123	1	196
3L	13871006	0	0	0	46	46
3L	13888962	0	4	0	5	9
3L	13901738	0	125	1	54	180
3L	13912261	0	0	0	2	2
3L	13919434	0	0	0	20	20
3L	13927002	0	0	0	18	18
3L	13929952	17	0	14	0	31
3L	13933146	62	0	0	0	62
3L	13933176	68	0	0	0	68
3L	13959984	12	0	31	0	43
3L	13962782	0	0	0	10	10
3L	13967324	0	0	2	0	2
3L	13974178	45	0	0	0	45
3L	14000997	0	0	0	22	22
3L	14001118	0	5	0	15	20
3L	14063120	0	0	0	0	0
3L	14066713	71	0	0	0	71
3L	14070532	0	0	0	0	0
3L	14071510	0	0	0	12	12
3L	14084672	0	0	0	1	1
3L	14084674	0	0	0	1	1
3L	14090360	0	0	0	0	0
3L	14090416	0	0	0	0	0
3L	14090417	0	0	0	0	0
3L	14096104	0	0	0	0	0
3L	14096107	0	0	0	0	0
3L	14096112	0	0	0	0	0
3L	14096121	0	0	0	0	0
3L	14096133	0	0	0	0	0
3L	14096136	0	0	0	0	0
3L	14096146	0	0	0	0	0
3L	14097465	0	0	0	0	0
3L	14097466	0	0	0	0	0
3L	14097468	0	0	0	0	0
3L	14097688	0	0	0	0	0
3L	14097689	0	0	0	0	0
3L	14097845	0	0	0	0	0
3L	14097870	0	0	0	0	0
3L	14097874	0	0	0	0	0
3L	14098080	0	0	0	0	0
3L	14098096	0	0	0	0	0
3L	14098097	0	0	0	0	0
3L	14098360	0	0	0	0	0
3L	14098377	0	0	0	0	0
3L	14098378	0	0	0	0	0
3L	14098379	0	0	0	0	0
3L	14100722	0	0	0	0	0
3L	14100724	0	0	0	0	0
3L	14111714	0	0	0	0	0
3L	14112636	0	3	0	16	19
3L	14212209	0	0	68	0	68
3L	14227988	1	0	0	0	1
3L	14235297	0	0	0	3	3
3L	14236740	13	0	0	0	13
3L	14368016	9	0	17	0	26
3L	14426456	0	0	0	0	0
3L	14439493	0	0	0	0	0
3L	14755055	0	0	0	0	0
3L	14764947	62	0	24	0	86
3L	14799253	40	0	6	0	46
3L	14862538	0	0	0	0	0
3L	14882352	0	0	0	0	0
3L	15043222	0	0	0	0	0
3L	15102878	1	0	0	0	1
3L	15102879	0	0	0	1	1
3L	15102886	1	0	0	0	1
3L	15102895	0	0	0	1	1
3L	15102896	1	0	0	0	1
3L	15102897	0	0	0	1	1
3L	15102934	0	0	0	1	1
3L	15102939	1	0	0	0	1
3L	15472441	0	0	0	0	0
3L	15517405	0	0	0	0	0
3L	15532890	0	0	0	0	0
3L	15555171	3	0	1	0	4
3L	15658259	0	0	0	0	0
3L	15658274	0	0	0	0	0
3L	15659522	0	0	0	0	0
3L	15757800	0	0	0	0	0
3L	15893762	0	18	0	38	56
3L	15895755	0	0	0	1	1
3L	16052231	2	0	3	0	5
3L	16111589	0	35	0	85	120
3L	16181016	0	0	0	0	0
3L	16181038	0	0	0	0	0
3L	16181052	0	0	0	0	0
3L	16181053	0	0	0	0	0
3L	16181094	0	0	0	0	0
3L	16182056	0	0	0	0	0
3L	16182169	0	0	0	0	0
3L	16182170	0	0	0	0	0
3L	16186140	0	0	0	0	0
3L	16186145	0	0	0	0	0
3L	16186363	0	0	0	0	0
3L	16254434	0	0	0	0	0
3L	16254435	0	0	0	0	0
3L	16255064	0	0	0	0	0
3L	16255072	0	0	0	0	0
3L	16262552	0	0	0	0	0
3L	16270810	0	0	0	0	0
3L	16291947	0	0	0	0	0
3L	16577155	0	0	0	0	0
3L	16616020	14	0	0	0	14
3L	16616021	0	0	0	14	14
3L	16617760	0	0	0	0	0
3L	16642757	0	0	0	0	0
3L	16645041	0	0	0	0	0
3L	16674672	0	0	2	0	2
3L	16678530	0	0	0	134	134
3L	16686521	0	0	0	0	0
3L	16688610	0	0	0	0	0
3L	16692734	1	0	0	0	1
3L	16728214	0	0	0	0	0
3L	16731471	0	0	0	0	0
3L	16736878	0	0	0	0	0
3L	16758529	0	0	0	0	0
3L	16786895	140	0	0	0	140
3L	16786980	0	0	0	0	0
3L	16908885	0	0	1	0	1
3L	16910270	0	0	2	0	2
3L	16968101	0	0	0	377	377
3L	17075627	0	4	0	1	5
3L	17378242	0	0	0	0	0
3L	17389187	0	0	0	0	0
3L	17425746	0	0	6	0	6
3L	17451133	13	1	0	0	14
3L	17475161	6	0	0	0	6
3L	17597746	0	16	0	6	22
3L	17668401	0	0	0	26	26
3L	17689993	0	0	0	0	0
3L	17726464	0	1	0	0	1
3L	17742206	0	0	0	8	8
3L	17951569	144	0	0	0	144
3L	17979662	0	0	0	0	0
3L	17979744	0	0	0	0	0
3L	18027635	0	0	0	1	1
3L	18087658	0	0	0	0	0
3L	18090225	0	0	0	0	0
3L	18132571	0	0	0	0	0
3L	18181206	0	0	0	0	0
3L	18189120	0	0	0	0	0
3L	18281392	0	0	0	0	0
3L	18281522	0	0	0	0	0
3L	18555038	0	0	0	0	0
3L	18596316	0	0	0	0	0
3L	18670895	0	0	0	103	103
3L	18682575	16	0	0	0	16
3L	18685220	0	6	0	15	21
3L	18685424	0	7	0	10	17
3L	18728861	0	0	0	0	0
3L	18800841	41	0	0	0	41
3L	18819562	0	0	0	19	19
3L	18878588	0	0	0	202	202
3L	18878936	0	0	0	343	343
3L	18897569	0	0	0	4	4
3L	18922609	0	0	0	11	11
3L	18922733	0	0	0	15	15
3L	19052915	0	0	0	0	0
3L	19055200	0	0	0	0	0
3L	19066432	0	0	0	25	25
3L	19067899	0	0	0	30	30
3L	19070611	0	0	0	0	0
3L	19106047	0	2	0	9	11
3L	19110288	0	30	0	11	41
3L	19147008	0	0	0	0	0
3L	19160049	0	1	0	0	1
3L	19283200	0	8	0	105	113
3L	19283264	0	56	0	64	120
3L	19283265	0	14	0	107	121
3L	19341568	0	0	0	50	50
3L	19369627	0	0	0	0	0
3L	19371398	0	0	0	0	0
3L	19399656	0	0	0	0	0
3L	19411978	0	0	0	0	0
3L	19501470	0	0	0	0	0
3L	19513044	0	0	0	0	0
3L	19516477	0	0	0	0	0
3L	19531391	0	0	0	0	0
3L	19542365	0	0	0	58	58
3L	19545728	0	0	6	0	6
3L	19578009	0	0	0	0	0
3L	19618855	0	0	0	2	2
3L	19689767	1164	0	171	0	1335
3L	19689870	128	0	729	0	857
3L	19689871	21	0	822	0	843
3L	19932956	0	0	0	0	0
3L	20035022	0	0	0	0	0
3L	20098494	0	0	0	146	146
3L	20156776	0	6	0	13	19
3L	20156958	0	18	0	35	53
3L	20252103	2	0	5	0	7
3L	20353020	0	0	0	54	54
3L	20379678	56	0	26	0	82
3L	20391933	0	0	0	15	15
3L	20420837	0	7	0	0	7
3L	20427294	0	13	0	6	19
3L	20428234	0	8	0	3	11
3L	20453518	0	0	0	2	2
3L	20465542	0	0	0	1	1
3L	20502571	1	0	0	0	1
3L	20502628	0	0	2	0	2
3L	20503418	2	0	1	0	3
3L	20523500	0	27	0	60	87
3L	20598406	0	5	0	6	11
3L	20598874	0	0	0	27	27
3L	20690411	0	0	0	0	0
3L	20768391	0	0	0	12	12
3L	20773150	62	0	168	0	230
3L	20773190	62	0	150	0	212
3L	20773546	204	0	22	0	226
3L	20773569	174	0	66	1	241
3L	20773589	198	0	39	0	237
3L	20773609	182	0	55	0	237
3L	20773610	173	0	68	0	241
3L	20802315	0	0	0	0	0
3L	20817830	0	0	0	3	3
3L	20820474	49	0	0	0	49
3L	20867520	0	0	0	1	1
3L	20879740	0	0	0	0	0
3L	20885034	0	36	0	60	96
3L	20942629	0	0	0	0	0
3L	20975576	0	1	0	0	1
3L	21072555	197	0	1	0	198
3L	21115651	0	0	0	0	0
3L	21118999	0	0	0	0	0
3L	21130550	0	0	0	0	0
3L	21130556	0	0	0	0	0
3L	21130559	0	0	0	0	0
3L	21130564	0	0	0	0	0
3L	21130610	0	0	0	0	0
3L	21130611	0	0	0	0	0
3L	21130618	0	0	0	0	0
3L	21130621	0	0	0	0	0
3L	21164936	0	0	0	0	0
3L	21179937	0	83	0	0	83
3L	21195648	0	0	0	4	4
3L	21203253	43	0	3	0	46
3L	21204995	1	0	0	0	1
3L	21205002	1	0	0	0	1
3L	21207897	41	0	3	0	44
3L	21210325	28	0	49	0	77
3L	21213292	46	0	42	0	88
3L	21226173	0	0	0	0	0
3L	21309631	0	1	0	0	1
3L	21333937	19	0	35	0	54
3L	21390253	0	0	0	0	0
3L	21390256	0	0	0	0	0
3L	21390260	0	0	0	0	0
3L	21390271	0	0	0	0	0
3L	21390275	0	0	0	0	0
3L	21390282	0	0	0	0	0
3L	21390294	0	0	0	0	0
3L	21390295	0	0	0	0	0
3L	21390303	0	0	0	0	0
3L	21390314	0	0	0	0	0
3L	21391007	1	0	0	0	1
3L	21391234	0	0	0	0	0
3L	21391240	0	1	0	0	1
3L	21644394	0	0	0	0	0
3L	21644396	0	0	0	0	0
3L	21644402	0	0	0	0	0
3L	21696292	1	0	0	0	1
3L	21696294	0	0	0	1	1
3L	21696345	0	0	1	0	1
3L	21696349	0	1	0	0	1
3L	21696352	0	0	0	1	1
3L	21696354	0	0	0	1	1
3L	21696356	0	1	0	0	1
3L	21696357	0	0	1	0	1
3L	21696361	0	1	0	0	1
3L	21696364	0	0	0	1	1
3L	21696375	1	0	0	0	1
3L	21696397	0	0	0	0	0
3L	21696400	0	0	0	0	0
3L	21696404	0	0	0	0	0
3L	21696405	0	0	0	0	0
3L	21696410	0	0	0	0	0
3L	21714311	0	0	0	0	0
3L	21715425	0	0	0	0	0
3L	21717050	0	0	0	0	0
3L	21728957	8	0	0	0	8
3L	21845812	0	0	0	0	0
3L	22132252	0	0	0	0	0
3L	22133068	0	0	0	0	0
3L	22133070	0	0	0	0	0
3L	22169386	0	0	0	0	0
3L	22268084	4	0	3	0	7
3L	22273143	468	0	31	0	499
3L	22273144	485	0	10	0	495
3L	22463672	0	0	0	2	2
3L	22655901	0	0	0	0	0
3L	22731262	2	0	0	0	2
3L	22793765	0	0	0	29	29
3L	22826560	0	0	0	0	0
3L	22827988	2	0	0	0	2
3L	22894950	0	0	0	0	0
3L	22894959	0	0	0	0	0
3L	23022502	27	0	2	0	29
3L	23022517	19	0	9	0	28
3L	23022531	19	0	5	0	24
3L	23022558	12	0	13	0	25
3L	23022565	11	0	14	0	25
3L	23022570	2	0	24	0	26
3L	23022589	7	0	19	0	26
3L	23022624	16	0	6	0	22
3L	23022651	22	0	1	0	23
3L	23022665	20	0	3	0	23
3L	23022696	23	0	3	0	26
3L	23022733	10	0	13	0	23
3L	23022747	17	0	8	0	25
3L	23022860	20	0	4	0	24
3L	23022915	18	0	7	0	25
3L	23023572	24	0	2	0	26
3L	23023737	20	0	11	0	31
3L	23023745	28	0	0	0	28
3L	23023746	24	0	3	0	27
3L	23023752	11	0	17	0	28
3L	23023759	15	0	16	0	31
3L	23023768	11	0	13	0	24
3L	23023772	11	0	14	0	25
3L	23023773	15	0	9	0	24
3L	23023776	19	0	6	0	25
3L	23023778	10	0	13	0	23
3L	23034648	19	0	106	0	125
3L	23035386	113	0	13	0	126
3L	23035498	82	0	25	0	107
3L	23035510	54	0	44	0	98
3L	23036047	127	0	19	0	146
3L	23036053	41	0	101	0	142
3L	23036055	121	0	24	0	145
3L	23036058	2	0	141	0	143
3L	23036059	76	0	67	0	143
3L	23036066	30	0	114	1	145
3L	23036068	54	0	89	0	143
3L	23036071	4	0	144	0	148
3L	23036082	103	1	40	0	144
3L	23036083	126	0	13	0	139
3L	23036084	133	0	13	0	146
3L	23036087	121	0	23	0	144
3L	23036098	105	0	32	0	137
3L	23036101	101	1	39	0	141
3L	23036116	84	0	59	0	143
3L	23036121	108	0	36	0	144
3L	23036453	97	0	34	0	131
3L	23036548	36	0	71	0	107
3L	23036588	40	0	55	0	95
3L	23036631	39	0	75	0	114
3L	23216253	0	0	0	0	0
3L	23228909	1	0	0	0	1
3L	23228910	0	0	1	0	1
3L	23228912	1	0	0	0	1
3L	23228932	0	0	1	0	1
3L	23231321	0	0	1	0	1
3L	23232223	2	0	0	0	2
3L	23241819	0	0	0	0	0
3L	23252714	2	0	0	0	2
3L	23284872	59	0	4	1	64
3L	23286473	118	0	14	0	132
3L	23286550	120	0	29	0	149
3L	23579149	1	0	0	0	1
3L	23742459	13	0	16	0	29
3L	23743265	16	0	3	0	19
3L	23743306	14	0	0	0	14
3L	23796662	0	0	0	0	0
3L	24031604	19	0	10	0	29
3L	24031889	10	0	10	0	20
3L	24031891	17	0	4	0	21
3L	24040526	1	0	0	0	1
3L	24074572	2	0	0	0	2
3L	24074586	1	0	1	0	2
3L	24074603	0	0	2	0	2
3L	24074606	1	0	1	0	2
3L	24074610	0	0	3	0	3
3L	24074617	2	0	1	0	3
3L	24074621	2	0	1	0	3
3L	24074625	1	0	2	0	3
3L	24074665	1	0	2	0	3
3L	24074669	0	0	2	0	2
3L	24074673	0	0	3	0	3
3L	24074677	0	0	2	0	2
3L	24074679	1	0	2	0	3
3L	24074680	0	0	2	0	2
3L	24074682	2	0	1	0	3
3L	24074685	2	0	1	0	3
3L	24074697	2	0	1	0	3
3L	24074700	2	0	1	0	3
3L	24074710	2	0	1	0	3
3L	24074713	1	0	2	0	3
3L	24074747	2	0	1	0	3
3L	24074754	3	0	0	0	3
3L	24074759	1	0	2	0	3
3L	24074986	1	0	1	0	2
3L	24184343	0	0	0	0	0
3L	24184352	0	0	0	0	0
3L	24260884	0	0	0	0	0
3L	24539756	1	0	1	0	2
3L	24574446	0	0	0	0	0
3L	24727794	0	0	0	0	0
3L	24729192	0	0	0	0	0
3L	24729203	0	0	0	0	0
3L	24729209	1	0	0	0	1
3L	24729558	1	0	0	0	1
3L	24734394	1	0	0	0	1
3L	24734409	1	0	0	0	1
3L	24734433	0	0	0	0	0
3L	24734434	0	0	0	0	0
3L	24734444	2	0	0	0	2
3L	24734445	2	0	0	0	2
3L	24734544	2	0	0	0	2
3L	24734545	2	0	0	0	2
3L	24734548	2	0	0	0	2
3L	24734549	2	0	0	0	2
3L	24734550	2	0	0	0	2
3L	24734565	2	0	0	0	2
3L	24734583	2	0	0	0	2
3L	24739737	0	0	0	0	0
3L	24739770	0	0	1	0	1
3L	24739940	0	0	0	0	0
3L	24739953	1	0	2	0	3
3L	25191188	0	0	0	0	0
3L	25404612	0	0	0	1	1
3L	25411101	0	0	0	0	0
3L	25440130	0	1	0	0	1
3L	25487370	0	0	0	0	0
3L	25519478	0	0	0	1	1
3L	25519484	0	0	0	1	1
3L	25519485	0	0	0	1	1
3L	25519514	0	0	0	1	1
3L	25519515	0	0	0	1	1
3L	25519516	0	0	0	1	1
3L	25519519	0	0	0	1	1
3L	25519523	0	0	0	1	1
3L	25519524	0	0	0	1	1
3L	25598311	0	2	0	0	2
3L	25608424	0	0	0	1	1
3L	25608425	0	1	0	0	1
3L	25608436	0	1	0	0	1
3L	25633906	0	1	0	0	1
3L	25633926	0	1	0	0	1
3L	25668383	0	0	0	1	1
3L	25668389	0	1	0	0	1
3L	25668390	0	0	0	1	1
3L	25668438	0	0	0	1	1
3L	25668442	0	0	0	1	1
3L	25668450	0	1	0	0	1
3L	25668451	0	1	0	0	1
3L	25668452	0	0	0	1	1
3L	25668462	0	0	0	0	0
3L	25668464	0	1	0	0	1
3L	25668466	0	1	0	0	1
3L	25668467	0	0	1	0	1
3L	25668501	0	1	0	0	1
3L	25668503	0	0	0	0	0
3L	25668653	0	0	0	0	0
3L	25669834	0	0	0	0	0
3L	25669886	0	0	0	1	1
3L	25669903	0	0	0	0	0
3L	25669904	0	0	0	0	0
3L	25669929	0	0	0	0	0
3L	25669935	0	0	0	0	0
3L	25674685	1	0	1	0	2
3L	25674703	0	0	2	0	2
3L	25674878	2	0	1	0	3
3L	25849333	0	0	0	0	0
3L	25873801	0	0	0	0	0
3L	25920861	0	0	0	1	1
3L	26001042	0	1	0	2	3
3L	26002127	0	0	0	7	7
3L	26002138	0	0	0	7	7
3L	26002140	0	0	0	7	7
3L	26002728	0	0	0	3	3
3L	26003264	0	2	0	4	6
3L	26009778	0	0	0	3	3
3L	26009830	0	0	0	2	2
3L	26012760	0	0	0	8	8
3L	26012768	0	0	0	7	7
3L	26582674	0	0	0	0	0
3L	26594673	0	0	0	0	0
3L	26610401	1	0	0	0	1
3L	26666453	0	0	0	0	0
3L	26667951	0	0	0	0	0
3L	26756592	0	0	0	0	0
3L	27281127	1	0	0	0	1
3L	27281185	1	0	0	0	1
3L	27845559	0	0	0	0	0
3L	27845560	0	0	0	0	0
3L	27845708	0	0	0	0	0
3L	28002470	0	0	0	1	1
3L	28002543	0	0	0	1	1
3L	28002555	0	0	0	1	1
3L	28002560	0	0	0	1	1
3L	28002748	0	0	0	0	0
3L	28002752	0	0	0	0	0
3R	2156963	0	0	0	0	0
3R	3122736	0	0	0	0	0
3R	3122737	0	0	0	0	0
3R	3751950	4	0	1	0	5
3R	4131662	0	0	1	0	1
3R	4185912	31	0	10	0	41
3R	4185926	22	0	19	0	41
3R	4185927	23	0	20	0	43
3R	4185928	39	0	5	0	44
3R	4186013	35	0	4	0	39
3R	4186020	33	0	4	0	37
3R	4186021	32	0	5	0	37
3R	4186029	38	0	0	0	38
3R	4186038	28	0	6	0	34
3R	4186053	27	0	8	0	35
3R	4186057	31	0	2	0	33
3R	4186060	27	0	4	0	31
3R	4186071	30	0	1	0	31
3R	4186077	32	0	0	0	32
3R	4186090	30	0	2	0	32
3R	4186091	18	0	12	0	30
3R	4279033	0	18	0	12	30
3R	4279036	0	24	0	10	34
3R	4279126	0	26	0	11	37
3R	4279127	0	25	0	10	35
3R	4279128	0	22	0	13	35
3R	4297057	176	0	41	0	217
3R	4297067	218	0	9	0	227
3R	4297086	220	0	7	0	227
3R	4297093	215	0	14	0	229
3R	4297095	203	0	22	0	225
3R	4297504	1290	0	942	0	2232
3R	4297517	1796	0	415	0	2211
3R	4297518	1519	0	695	0	2214
3R	4299218	233	0	25	0	258
3R	4299387	217	0	23	0	240
3R	4299391	155	0	75	0	230
3R	4301117	177	1	30	0	208
3R	4301124	202	0	8	0	210
3R	4301140	149	0	39	0	188
3R	4301142	147	0	39	0	186
3R	4301144	183	0	13	0	196
3R	4301150	126	0	65	0	191
3R	4301158	172	0	36	0	208
3R	4301166	216	0	16	0	232
3R	4301174	221	0	23	1	245
3R	4301182	244	0	25	0	269
3R	4301190	211	1	49	0	261
3R	4301192	219	1	40	0	260
3R	4301196	221	0	36	0	257
3R	4301198	210	0	50	0	260
3R	4301200	204	0	54	0	258
3R	4301206	195	0	60	0	255
3R	4301208	220	0	39	0	259
3R	4301212	216	0	41	0	257
3R	4301214	227	0	31	0	258
3R	4301216	235	0	19	0	254
3R	4301240	168	0	84	0	252
3R	4301244	146	0	100	1	247
3R	4301246	177	0	72	0	249
3R	4301248	234	0	17	0	251
3R	4301250	208	0	38	0	246
3R	4301252	264	0	20	0	284
3R	4301254	257	0	67	0	324
3R	4301258	256	0	87	0	343
3R	4365384	110	0	157	0	267
3R	4365385	8	0	254	0	262
3R	4365474	123	0	156	0	279
3R	4493894	0	15	0	11	26
3R	4656505	45	0	15	0	60
3R	4702574	37	0	16	0	53
3R	4944773	5	0	0	0	5
3R	4965472	81	0	0	0	81
3R	5084900	0	0	0	108	108
3R	5236209	0	73	0	463	536
3R	5236328	0	86	0	1042	1128
3R	5236329	1	357	0	810	1168
3R	5236332	0	1088	0	46	1134
3R	5236375	2	657	0	535	1194
3R	5236378	1	652	0	543	1196
3R	5260897	0	0	0	1	1
3R	5260900	1	0	0	0	1
3R	5260901	1	0	0	0	1
3R	5260908	0	0	0	1	1
3R	5260909	1	0	0	0	1
3R	5260910	0	0	1	0	1
3R	5260911	1	0	0	0	1
3R	5260913	0	0	0	1	1
3R	5260914	0	0	0	1	1
3R	5260918	1	0	0	0	1
3R	5260923	0	0	0	1	1
3R	5260926	0	0	0	1	1
3R	5260929	1	0	0	0	1
3R	5260930	0	0	0	1	1
3R	5260931	0	0	0	1	1
3R	5260932	0	0	0	1	1
3R	5260940	0	0	0	1	1
3R	5260941	1	0	0	0	1
3R	5260944	0	0	0	1	1
3R	5260945	0	0	1	0	1
3R	5260946	1	0	0	0	1
3R	5260947	0	0	0	1	1
3R	5260948	1	0	0	0	1
3R	5260949	0	0	0	1	1
3R	5260954	0	0	1	0	1
3R	5260956	0	0	0	1	1
3R	5260957	0	0	0	1	1
3R	5260958	0	0	0	1	1
3R	5260960	0	0	0	1	1
3R	5260961	0	0	0	1	1
3R	5260962	0	0	0	1	1
3R	5260963	0	0	0	1	1
3R	5260964	0	0	0	1	1
3R	5260965	0	0	0	1	1
3R	5260968	0	0	0	1	1
3R	5260969	0	0	0	1	1
3R	5260970	0	0	0	1	1
3R	5260971	1	0	0	0	1
3R	5260972	0	0	0	1	1
3R	5260973	1	0	0	0	1
3R	5260974	1	0	0	0	1
3R	5260976	0	0	0	1	1
3R	5260981	0	0	0	0	0
3R	5260982	0	0	0	0	0
3R	5260984	0	0	0	0	0
3R	5260985	0	0	0	0	0
3R	5260986	0	0	0	0	0
3R	5260987	0	0	0	0	0
3R	5260992	0	0	0	2	2
3R	5260993	1	0	1	0	2
3R	5260994	1	0	1	0	2
3R	5260995	0	0	0	2	2
3R	5260998	0	0	0	2	2
3R	5261005	0	0	0	2	2
3R	5261038	0	0	0	2	2
3R	5261039	0	0	0	2	2
3R	5261045	0	0	0	2	2
3R	5261046	0	0	0	2	2
3R	5261050	0	0	0	2	2
3R	5261052	0	0	0	2	2
3R	5261064	0	0	0	2	2
3R	5261070	0	0	0	2	2
3R	5261071	0	0	0	2	2
3R	5261073	0	0	0	2	2
3R	5268529	4	0	23	0	27
3R	5331180	0	0	0	2	2
3R	5456078	12	0	82	0	94
3R	5510248	0	6	0	67	73
3R	5512061	0	16	0	62	78
3R	5512062	0	12	0	66	78
3R	5579358	22	0	0	0	22
3R	5650231	54	1	49	0	104
3R	5650351	75	0	63	0	138
3R	5686487	15	0	4	0	19
3R	5794759	18	0	0	0	18
3R	5813914	0	0	0	19	19
3R	5835138	9	0	0	0	9
3R	6004380	0	372	0	463	835
3R	6198321	0	0	0	0	0
3R	6410404	1	0	0	0	1
3R	6454240	0	0	0	28	28
3R	6455990	0	22	0	17	39
3R	6456079	0	0	0	26	26
3R	6481790	0	0	0	2	2
3R	6482470	8	0	0	0	8
3R	6483189	4	0	1	0	5
3R	6646984	27	0	0	0	27
3R	6656412	0	0	0	54	54
3R	6825353	0	4	0	14	18
3R	7192775	38	0	315	0	353
3R	7192825	280	0	65	0	345
3R	7472957	0	0	0	9	9
3R	7474763	0	47	0	75	122
3R	7523172	0	0	0	0	0
3R	7527658	0	0	0	0	0
3R	7541970	0	0	0	0	0
3R	7541971	0	0	0	0	0
3R	7578932	0	2	0	0	2
3R	7632065	0	0	0	0	0
3R	7633948	0	0	0	1	1
3R	7857376	1	1	0	153	155
3R	7860890	0	5	0	21	26
3R	7886440	0	30	0	51	81
3R	7959962	0	0	0	2	2
3R	7975631	0	0	0	352	352
3R	8023269	0	42	0	110	152
3R	8025032	0	133	0	0	133
3R	8237633	0	0	0	32	32
3R	8380051	0	12	0	25	37
3R	8380439	0	32	0	23	55
3R	8380442	0	26	0	29	55
3R	8385971	0	0	0	46	46
3R	8386738	0	9	0	39	48
3R	8386758	0	9	0	25	34
3R	8658956	0	4	0	0	4
3R	8659112	0	4	0	0	4
3R	8661419	0	84	0	0	84
3R	8678362	0	0	25	0	25
3R	8736376	0	12	0	43	55
3R	8737810	0	22	0	23	45
3R	8775615	0	631	0	0	631
3R	8788015	0	0	0	0	0
3R	8788344	0	0	0	0	0
3R	8791608	0	2	0	0	2
3R	8795508	0	0	0	0	0
3R	8812828	0	20	0	0	20
3R	8834533	0	223	0	0	223
3R	8836915	0	60	0	19	79
3R	8836926	0	50	0	26	76
3R	8836929	0	37	0	40	77
3R	8837184	0	91	0	35	126
3R	8837191	0	91	0	33	124
3R	8837610	0	67	0	54	121
3R	8851870	0	1	0	0	1
3R	8864798	0	0	0	54	54
3R	8864972	0	0	0	73	73
3R	8867172	0	0	0	0	0
3R	8922284	0	0	0	0	0
3R	8937081	0	0	0	0	0
3R	8952096	0	0	0	0	0
3R	8992964	0	0	4	0	4
3R	9092757	0	4	0	0	4
3R	9094689	0	3	0	0	3
3R	9120444	0	8	0	0	8
3R	9134740	0	0	0	0	0
3R	9147309	0	2	0	0	2
3R	9192083	0	0	0	1	1
3R	9192878	0	2	0	0	2
3R	9195940	0	1	0	0	1
3R	9350774	0	0	0	0	0
3R	9354339	1	0	0	0	1
3R	9385249	0	3	0	0	3
3R	9394121	0	1	0	18	19
3R	9418495	28	0	2	0	30
3R	9418834	22	0	7	0	29
3R	9419410	26	0	7	0	33
3R	9419457	19	0	8	0	27
3R	9421085	10	0	0	0	10
3R	9428183	8	0	0	0	8
3R	9428227	8	0	2	0	10
3R	9428853	5	0	10	0	15
3R	9430861	7	0	6	0	13
3R	9430877	11	0	2	0	13
3R	9448522	313	0	73	0	386
3R	9451570	280	0	0	0	280
3R	9451939	232	0	109	0	341
3R	9455622	0	0	0	16	16
3R	9465643	0	0	0	62	62
3R	9492559	0	0	0	6	6
3R	9525980	0	0	91	0	91
3R	9544703	0	1	0	15	16
3R	9544820	0	4	0	16	20
3R	9591515	56	0	0	0	56
3R	9591859	34	0	0	0	34
3R	9614889	0	0	0	0	0
3R	9666847	0	0	0	0	0
3R	9721112	0	83	0	0	83
3R	9727213	0	74	0	0	74
3R	9729053	0	0	0	148	148
3R	9754511	0	16	0	0	16
3R	9761125	44	0	0	0	44
3R	9769425	126	0	71	0	197
3R	9798395	0	0	0	97	97
3R	9965066	0	0	0	0	0
3R	10029831	0	0	0	0	0
3R	10083460	3	0	0	0	3
3R	10097183	3	0	0	0	3
3R	10194903	43	0	20	0	63
3R	10194972	36	0	14	0	50
3R	10194990	28	0	18	0	46
3R	10195423	316	0	36	1	353
3R	10195426	11	0	322	0	333
3R	10195571	67	0	0	0	67
3R	10195983	184	0	93	0	277
3R	10195984	117	0	163	0	280
3R	10227022	5	0	9	0	14
3R	10228870	116	0	0	0	116
3R	10245424	117	0	27	0	144
3R	10245425	43	0	103	0	146
3R	10305770	48	0	0	0	48
3R	10333913	5	0	0	0	5
3R	10372369	0	0	0	15	15
3R	10391255	11	0	0	0	11
3R	10392923	11	0	0	0	11
3R	10393067	6	0	0	0	6
3R	10394318	12	0	0	0	12
3R	10515812	0	0	0	3	3
3R	10558186	0	0	0	1	1
3R	10584920	0	51	0	82	133
3R	10585180	0	27	0	31	58
3R	10585186	0	21	0	35	56
3R	10766619	0	0	35	0	35
3R	10768515	0	20	0	86	106
3R	10776609	0	0	0	3	3
3R	10782974	0	39	0	0	39
3R	10871792	0	0	0	242	242
3R	11127820	0	0	0	28	28
3R	11193273	0	0	0	0	0
3R	11398476	78	0	109	0	187
3R	11398478	153	0	37	0	190
3R	11450201	0	1	0	0	1
3R	11589338	0	0	0	55	55
3R	11765112	0	20	0	68	88
3R	11801192	0	71	0	56	127
3R	11951530	121	0	45	0	166
3R	11951562	61	0	103	0	164
3R	11953544	1	0	252	0	253
3R	11985293	0	539	0	0	539
3R	11989608	0	29	0	0	29
3R	11994674	0	149	0	0	149
3R	12079394	0	12	0	17	29
3R	12079473	0	9	0	23	32
3R	12096226	30	0	0	0	30
3R	12163774	0	0	0	982	982
3R	12164347	0	141	0	770	911
3R	12215148	15	0	0	0	15
3R	12283052	0	0	0	0	0
3R	12411087	98	0	0	0	98
3R	12416318	39	0	0	0	39
3R	12516932	0	15	0	31	46
3R	12593574	0	1	0	15	16
3R	12593953	0	2	0	30	32
3R	12594802	0	1	0	18	19
3R	12705537	0	0	0	0	0
3R	12741372	0	0	0	0	0
3R	13004750	0	1	105	0	106
3R	13004828	1	0	108	0	109
3R	13018291	5	0	0	0	5
3R	13373289	0	0	1	641	642
3R	13382634	5	0	0	0	5
3R	13399579	0	224	0	0	224
3R	13462029	0	0	60	0	60
3R	13528966	0	0	0	0	0
3R	13663586	0	0	308	0	308
3R	13692592	67	0	26	0	93
3R	13692593	85	0	14	0	99
3R	13725311	0	0	0	0	0
3R	13782016	0	0	2	0	2
3R	13782327	0	0	0	0	0
3R	13959841	0	0	606	0	606
3R	13993445	0	0	0	14	14
3R	14105598	0	32	0	0	32
3R	14108210	0	10	0	0	10
3R	14128425	0	0	40	0	40
3R	14330746	0	0	0	89	89
3R	14363401	0	0	0	0	0
3R	14363405	0	0	0	0	0
3R	14395408	0	0	0	82	82
3R	14409075	0	0	0	57	57
3R	14515193	1	2	0	62	65
3R	14522391	2	0	802	0	804
3R	14623285	0	0	0	104	104
3R	14735962	0	3	0	0	3
3R	14746231	0	0	0	73	73
3R	14746547	0	1	0	101	102
3R	14747108	0	0	0	76	76
3R	14788816	0	1	67	0	68
3R	14809014	0	0	0	2	2
3R	14880381	13	0	0	0	13
3R	14891090	0	0	1317	0	1317
3R	14903154	0	0	0	0	0
3R	14919312	48	0	0	0	48
3R	14996135	0	0	0	0	0
3R	15097165	0	8	0	49	57
3R	15099803	0	0	0	101	101
3R	15287927	1	0	1	0	2
3R	15288163	16	0	0	0	16
3R	15294740	16	0	1	0	17
3R	15296683	1085	0	15	0	1100
3R	15296695	1099	1	6	0	1106
3R	15297732	4	0	0	0	4
3R	15298760	3	0	0	0	3
3R	15306860	13	0	0	0	13
3R	15306861	14	0	0	0	14
3R	15384375	17	0	4	0	21
3R	15387222	123	0	89	0	212
3R	15388396	79	0	120	0	199
3R	15392578	171	0	0	0	171
3R	15399446	79	0	139	0	218
3R	15400137	29	0	0	0	29
3R	15400209	14	0	3	0	17
3R	15400211	18	0	2	0	20
3R	15400224	0	0	17	1	18
3R	15401498	0	0	0	178	178
3R	15413254	95	0	152	0	247
3R	15413305	112	0	149	0	261
3R	15413827	0	0	132	1	133
3R	15822468	136	0	26	0	162
3R	15950619	0	0	0	5	5
3R	16003657	14	0	32	0	46
3R	16045954	0	4	0	4	8
3R	16065967	0	1	0	3	4
3R	16087664	0	0	0	0	0
3R	16096668	0	91	0	43	134
3R	16097238	0	42	0	81	123
3R	16302773	53	0	32	0	85
3R	16302775	48	0	38	0	86
3R	16303403	81	0	23	0	104
3R	16303415	90	0	17	0	107
3R	16502786	9	0	0	0	9
3R	16591505	0	0	0	1	1
3R	16633290	172	0	15	0	187
3R	16633369	61	0	62	0	123
3R	16809936	0	0	0	0	0
3R	16827828	0	0	0	0	0
3R	17140246	0	0	0	0	0
3R	17149369	0	0	0	23	23
3R	17502097	0	0	0	0	0
3R	17544578	75	0	37	0	112
3R	17544743	83	0	39	0	122
3R	17750942	0	0	0	9	9
3R	17750957	0	4	0	7	11
3R	17770919	0	50	0	0	50
3R	17771810	0	81	0	0	81
3R	17772922	0	84	0	0	84
3R	17773982	0	6	0	4	10
3R	17774217	0	50	0	22	72
3R	17774401	0	0	41	0	41
3R	17774920	0	2	0	8	10
3R	17775731	0	18	0	0	18
3R	17778660	0	15	0	0	15
3R	17795473	0	0	22	0	22
3R	17796092	0	0	21	0	21
3R	17796780	0	66	0	0	66
3R	17797297	0	67	0	0	67
3R	17799317	0	14	0	0	14
3R	17808359	0	36	0	0	36
3R	17809478	0	6	0	0	6
3R	17852526	0	0	52	0	52
3R	17865673	0	0	61	0	61
3R	17873639	0	115	0	129	244
3R	17874391	0	248	0	0	248
3R	17877415	0	215	0	0	215
3R	17881420	0	145	0	67	212
3R	17881807	0	0	1	219	220
3R	17882765	0	98	0	7	105
3R	17897257	0	11	0	13	24
3R	17905164	0	0	0	78	78
3R	17905999	0	0	0	94	94
3R	17908804	65	0	0	0	65
3R	17938630	0	0	0	0	0
3R	17944246	0	0	0	0	0
3R	17945071	0	0	5	0	5
3R	17945344	0	0	7	0	7
3R	17945752	0	0	5	0	5
3R	17946291	0	0	6	0	6
3R	17947397	64	0	0	0	64
3R	17949372	0	0	0	0	0
3R	17967291	0	0	130	0	130
3R	17967728	163	0	18	0	181
3R	17976866	0	0	2	0	2
3R	17980448	3	0	3	0	6
3R	17986938	1	0	0	0	1
3R	17992257	5	0	0	0	5
3R	17994037	6	0	0	0	6
3R	17994206	6	0	0	0	6
3R	18017356	90	0	0	0	90
3R	18133238	9	0	0	0	9
3R	18199189	0	0	0	28	28
3R	18205263	3	0	0	0	3
3R	18226004	0	0	0	28	28
3R	18236442	48	0	0	0	48
3R	18238159	99	0	0	0	99
3R	18290939	0	17	0	79	96
3R	18355194	0	33	0	14	47
3R	18355198	0	29	0	20	49
3R	18355305	0	23	0	22	45
3R	18360355	0	2	0	12	14
3R	18498021	0	0	0	0	0
3R	18599594	0	1	0	0	1
3R	18674009	4	0	0	0	4
3R	18801700	0	11	0	48	59
3R	18806029	0	11	0	32	43
3R	18824181	0	0	0	0	0
3R	18881308	0	0	0	0	0
3R	18907574	558	0	67	0	625
3R	18907652	175	0	475	0	650
3R	18907675	183	0	427	0	610
3R	18907799	255	0	147	0	402
3R	18907980	358	1	157	0	516
3R	18910005	223	0	8	0	231
3R	18910153	19	1	213	0	233
3R	18970679	344	0	26	0	370
3R	18970692	320	0	60	0	380
3R	18971312	257	0	115	0	372
3R	19081553	0	0	0	0	0
3R	19140149	0	23	0	73	96
3R	19141001	0	24	0	112	136
3R	19218093	0	0	0	1	1
3R	19231096	1	63	0	287	351
3R	19231097	0	121	0	228	349
3R	19231100	0	27	0	325	352
3R	19238197	0	152	0	172	324
3R	19238358	0	122	0	189	311
3R	19238845	0	78	0	178	256
3R	19389278	0	0	0	0	0
3R	19579291	0	0	1	0	1
3R	19637450	0	0	0	50	50
3R	19643921	0	33	0	0	33
3R	19653645	0	57	0	36	93
3R	19660641	0	0	1	0	1
3R	19662383	26	0	27	0	53
3R	19662407	0	0	51	0	51
3R	19734535	2	0	1	0	3
3R	19753763	47	0	130	0	177
3R	19753764	13	0	165	0	178
3R	19763634	35	0	200	0	235
3R	19765660	80	0	48	0	128
3R	19766576	0	0	174	0	174
3R	19836444	0	0	0	5	5
3R	19840656	0	0	0	0	0
3R	19847652	6	0	0	0	6
3R	19848089	2	0	1	0	3
3R	19848545	7	0	0	0	7
3R	19850222	58	0	92	0	150
3R	19901320	1	176	0	0	177
3R	19901682	0	0	0	178	178
3R	19914707	0	0	0	576	576
3R	19977151	0	0	0	0	0
3R	20037752	0	36	0	45	81
3R	20253305	5	0	0	0	5
3R	20253308	6	0	0	0	6
3R	20254800	0	0	0	0	0
3R	20322199	120	0	103	0	223
3R	20323426	0	0	139	0	139
3R	20397317	0	0	0	6	6
3R	20397347	0	0	0	3	3
3R	20397348	0	0	0	3	3
3R	20397350	0	0	0	3	3
3R	20397351	0	0	0	3	3
3R	20397356	0	0	0	3	3
3R	20397361	0	0	0	3	3
3R	20397362	0	0	0	3	3
3R	20397364	0	0	0	3	3
3R	20397502	0	0	0	4	4
3R	20397510	0	0	0	4	4
3R	20397511	0	0	0	4	4
3R	20397525	0	0	0	5	5
3R	20397526	0	1	0	4	5
3R	20397527	0	1	0	3	4
3R	20442288	0	0	0	5	5
3R	20538040	0	0	0	26	26
3R	20964328	1895	1	1061	1	2958
3R	20965039	1620	0	1142	0	2762
3R	20978916	96	0	21	0	117
3R	20986865	4	0	0	0	4
3R	20993738	57	0	219	0	276
3R	20993841	74	0	229	0	303
3R	20993853	129	0	171	0	300
3R	21010468	76	0	7	0	83
3R	21010472	74	0	7	0	81
3R	21018588	19	0	67	0	86
3R	21018593	68	0	10	0	78
3R	21018596	29	0	51	0	80
3R	21018660	36	0	54	0	90
3R	21018693	15	0	81	0	96
3R	21018789	84	0	8	0	92
3R	21020302	17	0	13	0	30
3R	21020304	24	0	4	0	28
3R	21020562	10	0	12	0	22
3R	21032796	0	0	0	5	5
3R	21034155	0	0	0	2	2
3R	21035203	0	0	0	2	2
3R	21035311	0	0	0	1	1
3R	21036317	0	0	0	2	2
3R	21210519	21	0	0	0	21
3R	21213783	96	0	27	0	123
3R	21216016	57	0	0	0	57
3R	21228047	11	0	57	1	69
3R	21228182	18	0	52	0	70
3R	21268995	0	0	0	262	262
3R	21275768	0	0	0	281	281
3R	21277235	0	8	0	17	25
3R	21297848	403	0	48	0	451
3R	21316786	0	0	0	4	4
3R	21337167	0	19	0	37	56
3R	21360556	0	0	0	0	0
3R	21580556	0	18	0	0	18
3R	21795674	0	1	0	0	1
3R	21866357	0	6	0	0	6
3R	21979019	0	0	0	3	3
3R	22782190	10	0	1	0	11
3R	22784953	25	0	12	0	37
3R	23061604	14	0	0	0	14
3R	23081390	1	0	0	704	705
3R	23092053	0	0	0	0	0
3R	23112549	0	0	0	599	599
3R	23124996	0	3	0	9	12
3R	23124998	0	0	0	11	11
3R	23125099	0	0	0	17	17
3R	23125127	0	0	0	21	21
3R	23125179	0	0	0	20	20
3R	23125191	0	11	0	8	19
3R	23180642	0	0	0	0	0
3R	23183620	0	0	37	0	37
3R	23188969	0	257	0	0	257
3R	23191853	0	160	0	0	160
3R	23200370	0	9	0	0	9
3R	23228940	0	179	0	0	179
3R	23229652	0	0	0	117	117
3R	23229765	0	0	0	141	141
3R	23245868	0	0	0	0	0
3R	23248865	0	0	0	54	54
3R	23252005	0	0	0	0	0
3R	23261644	0	7	0	9	16
3R	23348613	1	0	0	0	1
3R	23348619	1	0	0	0	1
3R	23348769	0	0	0	0	0
3R	23348836	1	0	0	0	1
3R	23349750	2	0	0	0	2
3R	23355233	0	0	0	10	10
3R	23379528	0	0	0	38	38
3R	23662171	0	0	0	0	0
3R	23662433	0	0	0	0	0
3R	23806927	0	0	0	32	32
3R	23807724	0	41	0	0	41
3R	23812871	0	0	0	116	116
3R	23847794	0	0	118	0	118
3R	23848537	66	0	65	0	131
3R	23889222	0	0	0	5	5
3R	23889403	0	0	0	3	3
3R	23903183	0	0	0	68	68
3R	23906410	0	0	0	0	0
3R	23913774	0	0	0	0	0
3R	23930726	0	134	0	0	134
3R	23936205	0	901	0	1	902
3R	23941852	0	1	0	0	1
3R	23954031	0	44	0	0	44
3R	23954205	0	52	1	0	53
3R	23954270	0	40	0	0	40
3R	23975656	0	0	8	0	8
3R	23976395	0	0	327	0	327
3R	23981667	76	0	32	0	108
3R	23982357	303	1	46	0	350
3R	23983504	412	0	63	0	475
3R	23999913	0	131	0	0	131
3R	24000236	0	169	0	0	169
3R	24000858	0	5	0	12	17
3R	24028532	0	0	0	0	0
3R	24028545	0	0	0	0	0
3R	24035862	1	90	0	0	91
3R	24038324	0	0	22	0	22
3R	24051777	0	0	125	0	125
3R	24059369	0	0	25	0	25
3R	24059405	0	0	23	0	23
3R	24063411	22	0	0	0	22
3R	24065016	0	37	0	0	37
3R	24079314	0	2	0	0	2
3R	24080205	0	1	0	0	1
3R	24080856	0	0	0	0	0
3R	24089901	0	2	0	0	2
3R	24094522	0	4	0	0	4
3R	24096044	0	2	0	0	2
3R	24103714	0	53	0	255	308
3R	24115231	0	166	0	0	166
3R	24136443	0	0	35	0	35
3R	24136633	0	0	21	0	21
3R	24136663	0	0	17	0	17
3R	24141432	0	0	15	0	15
3R	24157937	0	53	0	0	53
3R	24162927	0	30	0	0	30
3R	24214769	0	5	0	0	5
3R	24228774	0	7	0	0	7
3R	24235203	0	0	0	0	0
3R	24292106	39	0	0	0	39
3R	24308629	48	0	26	0	74
3R	24309492	67	0	39	0	106
3R	24311331	36	0	33	0	69
3R	24399715	34	0	0	0	34
3R	24401818	0	41	0	40	81
3R	24511651	0	33	0	82	115
3R	24511656	0	35	0	79	114
3R	24512020	0	6	0	15	21
3R	24512901	0	2	0	23	25
3R	24512911	0	0	0	22	22
3R	24600699	1	0	0	0	1
3R	24668815	39	0	5	1	45
3R	24674513	183	0	19	0	202
3R	24675475	32	1	8	0	41
3R	24675663	16	0	128	0	144
3R	24690643	10	0	3	0	13
3R	24691493	191	0	20	0	211
3R	24692577	3	0	5	0	8
3R	24697793	17	0	3	0	20
3R	24706551	24	0	262	0	286
3R	24707423	46	0	185	0	231
3R	24707696	179	0	65	0	244
3R	24707890	289	0	55	0	344
3R	24708326	117	0	44	0	161
3R	24708329	132	0	24	0	156
3R	24708330	100	0	54	0	154
3R	24708356	122	0	32	0	154
3R	24829203	0	0	0	94	94
3R	25026672	23	0	0	0	23
3R	25039627	248	0	0	0	248
3R	25134628	1	0	0	0	1
3R	25136056	67	0	0	0	67
3R	25268354	2	0	0	0	2
3R	25346655	0	17	0	72	89
3R	25516393	5	0	0	0	5
3R	25530500	0	0	0	0	0
3R	25607422	0	0	0	14	14
3R	25680862	99	0	0	0	99
3R	25871448	44	0	0	0	44
3R	25871506	35	0	0	0	35
3R	25871531	34	0	0	0	34
3R	25871712	42	0	0	0	42
3R	25871911	52	0	0	0	52
3R	25965631	289	0	87	0	376
3R	25965643	3	0	370	0	373
3R	26275388	47	0	0	0	47
3R	26344955	0	0	0	0	0
3R	26384361	0	0	0	0	0
3R	26533202	0	4	0	4	8
3R	26533203	0	1	0	7	8
3R	26533204	0	2	0	6	8
3R	26533205	0	1	0	7	8
3R	26544601	0	0	0	0	0
3R	26555239	78	0	35	0	113
3R	26572578	2	0	0	0	2
3R	26593045	9	0	2	0	11
3R	26601314	0	0	80	0	80
3R	26681389	0	0	0	51	51
3R	26698436	0	0	0	241	241
3R	26699744	0	148	0	294	442
3R	26703453	0	0	0	7	7
3R	26706990	0	0	0	0	0
3R	26707060	0	0	0	0	0
3R	26710227	0	0	0	1	1
3R	26710639	0	0	0	0	0
3R	26711278	0	0	0	0	0
3R	26711482	0	0	0	1	1
3R	26722743	0	0	0	49	49
3R	26799601	0	0	0	0	0
3R	26803090	0	0	0	0	0
3R	26839293	0	0	73	0	73
3R	26839692	100	0	0	0	100
3R	26854725	0	0	0	2	2
3R	26869981	0	0	0	734	734
3R	26870035	0	0	0	798	798
3R	26898498	0	0	0	0	0
3R	26922349	0	0	0	0	0
3R	26941648	121	0	0	0	121
3R	26942517	0	0	117	0	117
3R	26950965	0	0	0	350	350
3R	26964540	0	16	0	0	16
3R	26971309	43	0	0	0	43
3R	27006713	0	0	0	0	0
3R	27059393	0	0	0	2	2
3R	27065920	0	0	0	65	65
3R	27065932	0	0	1	47	48
3R	27101403	0	0	0	13	13
3R	27155499	321	0	0	0	321
3R	27159080	72	0	0	0	72
3R	27237462	0	0	0	111	111
3R	27255644	101	0	0	0	101
3R	27260195	0	0	0	64	64
3R	27275221	4	0	2	0	6
3R	27436670	0	0	0	33	33
3R	27581330	0	3	0	3	6
3R	27610850	0	0	0	0	0
3R	27643914	0	32	0	283	315
3R	27669340	124	0	63	0	187
3R	27673172	141	0	123	0	264
3R	27673289	41	0	240	1	282
3R	27674209	190	2	0	0	192
3R	27674284	225	0	0	0	225
3R	27674568	97	0	183	0	280
3R	27674719	221	0	74	0	295
3R	27674736	26	0	263	1	290
3R	27674878	65	0	244	0	309
3R	27674907	126	0	171	0	297
3R	27675074	262	0	113	0	375
3R	27676160	279	0	82	0	361
3R	27676232	128	1	131	0	260
3R	27923909	1	0	0	0	1
3R	27928133	0	7	0	0	7
3R	27949844	0	0	127	0	127
3R	27954914	0	3	0	0	3
3R	27955650	0	0	15	0	15
3R	27956797	0	0	21	0	21
3R	27957947	0	27	0	0	27
3R	27965771	0	0	22	0	22
3R	27965792	0	0	22	0	22
3R	27966580	0	0	25	0	25
3R	27987451	0	0	0	0	0
3R	28077291	0	0	0	0	0
3R	28211257	0	0	1	0	1
3R	28418412	89	0	0	0	89
3R	28598794	0	21	0	19	40
3R	28630348	0	0	0	1	1
3R	28740661	0	0	0	0	0
3R	28755588	0	0	0	0	0
3R	28755612	0	0	0	0	0
3R	28824334	16	0	0	0	16
3R	28825660	0	90	0	0	90
3R	28834732	0	87	0	0	87
3R	28841035	0	0	0	0	0
3R	28842883	0	2	0	0	2
3R	28845314	0	12	0	0	12
3R	28845906	0	0	44	0	44
3R	28874903	70	0	0	0	70
3R	28877734	0	0	0	3	3
3R	28883203	0	0	0	0	0
3R	28893176	0	0	40	0	40
3R	28903133	16	0	0	0	16
3R	28910138	54	0	0	0	54
3R	28925501	0	0	0	53	53
3R	29682986	5	0	3	0	8
3R	29725169	0	0	52	0	52
3R	29809019	0	0	10	0	10
3R	29852709	42	0	0	0	42
3R	29877130	107	0	0	0	107
3R	29877330	135	0	0	0	135
3R	29877364	113	0	0	0	113
3R	29990367	61	0	0	0	61
3R	29991674	0	0	0	23	23
3R	30002686	0	0	0	90	90
3R	30012340	0	0	0	5	5
3R	30012471	0	0	0	14	14
3R	30014618	0	0	0	16	16
3R	30036766	0	0	0	14	14
3R	30040555	35	0	0	0	35
3R	30083131	7	0	0	0	7
3R	30092365	10	0	0	0	10
3R	30103150	38	0	0	0	38
3R	30104256	252	0	0	0	252
3R	30112301	0	0	250	0	250
3R	30113784	63	0	0	0	63
3R	30114780	35	0	0	0	35
3R	30115158	40	0	0	0	40
3R	30199030	0	0	0	0	0
3R	30303048	0	0	0	0	0
3R	30420927	0	0	0	87	87
3R	30774448	22	0	0	0	22
3R	30796901	0	1	0	0	1
3R	31046504	14	0	3	0	17
3R	31160434	6	0	0	0	6
3R	31228686	107	0	12	0	119
3R	31597431	0	87	0	280	367
3R	31597432	0	122	0	242	364
3R	31599016	0	83	0	758	841
3R	31601718	0	213	0	493	706
3R	31601828	0	156	0	839	995
3R	31602191	0	221	1	1147	1369
3R	31608331	0	3	0	15	18
3R	31724907	1	0	0	0	1
3R	31837086	32	0	25	0	57
3R	31837089	24	0	34	0	58
3R	31844215	40	0	26	0	66
3R	31844748	98	0	27	0	125
4	55144	0	0	0	1	1
4	76506	0	0	0	0	0
4	86500	0	0	0	0	0
4	100011	34	0	4	0	38
4	100035	8	0	24	0	32
4	100181	3	0	36	0	39
4	100197	18	0	14	0	32
4	100200	26	0	10	0	36
4	100204	26	0	12	0	38
4	100214	29	0	10	0	39
4	100219	25	0	3	0	28
4	100289	55	0	9	0	64
4	100442	70	0	3	0	73
4	100530	78	0	10	0	88
4	100539	76	0	8	0	84
4	100543	47	0	34	0	81
4	100547	78	0	7	0	85
4	100549	32	0	53	0	85
4	100554	53	0	33	0	86
4	100556	84	0	1	0	85
4	100557	44	0	38	0	82
4	100558	67	0	15	0	82
4	100559	58	0	21	1	80
4	100560	16	0	63	0	79
4	100563	6	0	75	0	81
4	100629	31	0	17	0	48
4	101660	10	0	78	0	88
4	102327	49	0	46	0	95
4	102349	32	0	41	0	73
4	113007	122	0	72	2	196
4	126831	0	0	0	1	1
4	126842	0	0	0	1	1
4	128747	0	1	0	1	2
4	182444	0	0	0	2	2
4	182525	0	3	0	2	5
4	191689	0	11	0	9	20
4	191704	0	10	0	10	20
4	191708	0	5	0	16	21
4	192653	0	5	0	17	22
4	192661	0	19	0	2	21
4	192670	0	12	0	15	27
4	192672	0	7	0	20	27
4	192677	0	21	0	4	25
4	192684	0	9	0	19	28
4	192692	0	17	0	16	33
4	192715	0	26	0	14	40
4	192723	0	11	0	25	36
4	192724	0	12	0	25	37
4	213353	14	0	25	0	39
4	213371	27	0	14	0	41
4	214241	17	0	10	0	27
4	234621	4	0	2	0	6
4	234717	5	0	0	0	5
4	234747	2	0	3	0	5
4	234775	2	0	2	0	4
4	234798	3	0	0	0	3
4	235270	6	0	0	0	6
4	235273	5	0	1	0	6
4	235277	6	0	0	0	6
4	235278	6	0	0	0	6
4	235280	5	0	0	0	5
4	235284	4	0	1	0	5
4	235287	2	0	3	0	5
4	235308	5	0	0	0	5
4	235309	6	0	0	0	6
4	235310	6	0	0	0	6
4	235311	5	0	0	0	5
4	235313	3	0	2	0	5
4	235317	6	0	0	0	6
4	235319	4	0	1	0	5
4	235336	3	0	2	0	5
4	235338	5	0	0	0	5
4	235343	6	0	1	0	7
4	235344	7	0	0	0	7
4	235495	6	0	1	0	7
4	235496	5	0	1	0	6
4	235506	5	0	0	0	5
4	265270	33	0	0	0	33
4	265273	31	0	0	0	31
4	292019	0	2	0	0	2
4	292441	0	1	0	0	1
4	294654	0	2	0	0	2
4	295725	0	0	0	3	3
4	304161	0	0	0	0	0
4	328580	0	2	0	9	11
4	339075	0	11	0	31	42
4	340376	0	20	0	12	32
4	340381	0	7	0	30	37
4	340398	0	12	0	25	37
4	341198	0	1	0	32	33
4	341200	0	3	0	29	32
4	343860	0	1	0	1	2
4	351351	0	0	0	6	6
4	351417	0	1	0	3	4
4	356697	0	1	0	0	1
4	356702	0	1	0	0	1
4	356711	0	1	0	0	1
4	356722	0	1	0	0	1
4	356723	0	1	0	0	1
4	356726	0	0	0	1	1
4	356734	0	1	0	0	1
4	356773	0	2	0	0	2
4	357621	0	0	0	0	0
4	357626	0	0	0	0	0
4	357672	0	0	0	0	0
4	357673	0	0	0	0	0
4	367899	11	0	2	0	13
4	403085	0	0	1	0	1
4	446514	131	0	27	0	158
4	446530	147	0	20	0	167
4	448154	33	0	15	0	48
4	448773	48	0	14	0	62
4	449601	90	0	7	0	97
4	449602	82	0	14	0	96
4	449672	75	0	8	0	83
4	449705	81	0	5	0	86
4	449711	78	0	6	0	84
4	449740	71	0	6	0	77
4	449751	68	0	12	0	80
4	449767	61	0	15	0	76
4	454069	78	0	1	0	79
4	454073	75	0	0	0	75
4	454076	67	0	5	0	72
4	454085	61	0	12	0	73
4	455119	1	0	6	0	7
4	455123	6	0	2	0	8
4	455582	10	0	4	0	14
4	455778	8	0	2	0	10
4	459603	10	0	0	0	10
4	459637	9	0	0	0	9
4	476665	0	6	0	8	14
4	476688	0	10	0	1	11
4	476701	0	4	0	5	9
4	476921	0	5	0	12	17
4	520535	1	0	0	0	1
4	541492	0	16	0	25	41
4	541536	0	23	0	12	35
4	541538	0	11	0	24	35
4	541539	0	33	0	3	36
4	541545	0	8	0	27	35
4	541585	0	16	0	19	35
4	541776	0	4	0	23	27
4	541778	0	12	0	15	27
4	541780	0	2	0	25	27
4	541782	0	14	0	13	27
4	541784	0	12	1	13	26
4	541793	28	0	0	0	28
4	541795	0	4	0	28	32
4	541819	0	2	0	40	42
4	541822	0	5	0	35	40
4	541825	0	2	0	39	41
4	541826	0	3	0	38	41
4	541828	0	4	0	38	42
4	541882	0	2	0	43	45
4	541884	0	0	0	44	44
4	541886	0	6	0	39	45
4	541887	0	2	0	42	44
4	541889	0	7	0	37	44
4	541890	0	8	0	33	41
4	560912	49	0	2	0	51
4	560934	35	0	18	0	53
4	561097	34	0	8	0	42
4	563220	14	0	1	0	15
4	563252	8	0	0	0	8
4	563258	8	0	0	0	8
4	563274	8	0	0	0	8
4	563284	7	0	0	0	7
4	563291	0	0	1	0	1
4	563330	3	0	0	0	3
4	563333	3	0	0	0	3
4	563340	3	0	0	0	3
4	563347	3	0	1	0	4
4	563352	3	0	0	0	3
4	563354	3	0	1	0	4
4	563367	4	0	0	0	4
4	563368	3	0	2	0	5
4	563369	5	0	0	0	5
4	563370	3	0	1	0	4
4	563373	5	0	0	0	5
4	563377	5	0	0	0	5
4	563380	2	0	3	0	5
4	563383	6	0	0	0	6
4	563384	2	0	4	0	6
4	563385	0	0	6	0	6
4	563386	0	0	6	0	6
4	563390	2	0	4	0	6
4	563396	2	0	4	0	6
4	563398	3	0	3	0	6
4	563399	3	0	3	0	6
4	563401	6	0	0	0	6
4	563402	4	0	1	0	5
4	563403	2	0	4	0	6
4	563405	5	0	1	0	6
4	563409	4	0	1	0	5
4	563414	4	0	3	0	7
4	563416	7	0	1	0	8
4	563537	18	0	0	0	18
4	579932	17	0	0	0	17
4	579972	17	0	2	0	19
4	579974	17	0	1	1	19
4	579978	17	0	0	0	17
4	579980	18	0	0	0	18
4	602510	0	13	0	4	17
4	612525	9	0	0	0	9
4	636945	0	4	0	1	5
4	638429	0	0	0	19	19
4	653771	0	0	0	0	0
4	654895	0	4	0	17	21
4	654898	0	3	0	16	19
4	659412	0	2	0	59	61
4	667083	27	0	4	0	31
4	667084	24	0	8	0	32
4	667085	22	0	8	0	30
4	667101	14	0	8	0	22
4	667104	14	0	6	0	20
4	668200	23	0	4	0	27
4	668202	13	0	15	0	28
4	686912	70	0	19	0	89
4	686921	69	0	19	0	88
4	686924	54	0	31	0	85
4	686926	80	0	7	0	87
4	686929	44	0	42	0	86
4	686932	39	0	42	0	81
4	686941	81	0	4	0	85
4	686958	67	0	11	0	78
4	686973	71	0	15	0	86
4	686981	75	0	11	0	86
4	687294	21	0	25	0	46
4	688162	75	0	13	0	88
4	725144	0	0	0	0	0
4	743070	59	0	4	0	63
4	744196	0	0	0	0	0
4	744197	0	0	0	0	0
4	744213	0	0	0	0	0
4	744215	0	0	0	0	0
4	744797	1	0	0	0	1
4	744886	1	0	0	0	1
4	744897	1	0	0	0	1
4	745047	1	0	0	0	1
4	745107	2	0	0	0	2
4	747687	88	0	1	0	89
4	747738	64	0	29	0	93
4	767187	193	0	12	0	205
4	767264	150	1	22	0	173
4	823281	0	0	0	0	0
4	856273	0	4	0	7	11
4	856282	0	3	0	9	12
4	856311	0	8	0	5	13
4	856324	0	0	0	11	11
4	856326	0	4	0	7	11
4	856328	0	0	0	11	11
4	856331	0	1	0	10	11
4	856359	0	8	0	3	11
4	856373	0	3	0	8	11
4	857770	0	9	0	3	12
4	858835	0	10	0	4	14
4	858841	0	4	0	12	16
4	860159	0	4	0	10	14
4	860173	0	2	0	9	11
4	860227	0	11	0	7	18
4	860232	0	4	0	12	16
4	860236	0	3	0	16	19
4	874383	0	283	0	157	440
4	878970	0	141	0	383	524
4	879448	0	5	0	67	72
4	879496	0	50	0	14	64
4	879936	0	10	0	107	117
4	882370	0	56	0	90	146
4	889066	0	67	0	36	103
4	895648	0	0	0	1	1
4	896129	0	1	0	2	3
4	896139	0	1	0	1	2
4	896192	0	1	0	1	2
4	897223	0	0	0	1	1
4	897246	0	0	0	1	1
4	897262	0	0	0	1	1
4	897309	0	0	0	1	1
4	908982	0	5	0	9	14
4	980493	0	0	1	0	1
4	980622	2	0	0	0	2
4	999228	13	0	2	0	15
4	1039524	0	7	0	101	108
4	1039649	0	8	0	91	99
4	1040392	0	10	0	113	123
4	1040397	0	32	0	101	133
4	1041214	0	105	0	99	204
4	1041225	0	111	0	128	239
4	1041307	1	148	0	86	235
4	1041381	0	38	1	185	224
4	1041388	0	55	0	168	223
4	1041389	0	36	0	190	226
4	1041395	0	35	0	173	208
4	1041418	0	17	0	204	221
4	1041449	0	29	0	173	202
4	1041451	0	80	0	121	201
4	1041452	0	32	0	175	207
4	1041464	0	4	0	195	199
4	1041465	0	19	0	176	195
4	1041478	0	46	0	146	192
4	1041482	0	33	0	153	186
4	1041483	0	9	0	182	191
4	1041494	1	79	0	95	175
4	1041500	0	17	0	152	169
4	1041514	0	45	0	145	190
4	1041521	0	23	0	161	184
4	1041544	0	45	0	126	171
4	1042206	0	43	0	121	164
4	1042231	0	26	0	168	194
4	1042257	0	59	0	136	195
4	1042367	0	9	0	229	238
4	1042368	0	26	0	217	243
4	1042371	0	100	0	145	245
4	1042502	0	80	0	152	232
4	1042610	0	97	1	100	198
4	1042667	0	24	0	197	221
4	1042794	0	12	0	193	205
4	1042907	0	26	0	142	168
4	1042971	0	6	0	126	132
4	1042975	0	20	0	115	135
4	1045395	0	0	0	1	1
4	1045396	0	0	0	1	1
4	1046984	0	2	0	2	4
4	1046986	0	0	0	6	6
4	1046987	0	0	0	6	6
4	1051636	0	9	0	25	34
4	1052332	0	1	0	1	2
4	1125511	1	0	0	0	1
4	1125515	1	0	0	0	1
4	1125529	1	0	0	0	1
4	1125587	0	0	1	0	1
4	1125632	0	0	1	0	1
4	1126049	3	0	0	0	3
4	1126064	3	0	0	0	3
4	1126065	3	0	0	0	3
4	1126078	2	0	0	0	2
4	1126349	1	0	1	0	2
4	1132912	25	0	11	0	36
4	1132913	35	0	1	0	36
4	1132915	9	0	28	0	37
4	1132917	30	0	8	0	38
4	1132932	31	0	9	0	40
4	1132946	11	0	31	0	42
4	1133654	6	0	42	0	48
4	1133655	26	0	21	0	47
4	1134443	164	0	60	0	224
4	1134452	185	0	22	0	207
4	1134469	140	0	62	0	202
4	1134830	125	0	17	0	142
4	1134861	41	0	99	0	140
4	1134869	127	0	28	0	155
4	1136039	38	0	7	0	45
4	1136068	35	0	3	0	38
4	1137308	4	0	28	0	32
4	1148236	3	0	1	0	4
4	1148466	0	0	12	0	12
4	1168877	6	0	13	0	19
4	1232612	4	0	1	0	5
4	1232942	4	0	5	0	9
4	1234422	8	0	1	0	9
4	1234429	9	0	1	0	10
4	1244706	7	0	9	0	16
4	1244726	6	0	4	0	10
4	1244727	3	0	6	0	9
4	1252829	24	0	26	0	50
4	1252993	40	0	8	0	48
4	1254576	30	0	14	0	44
4	1255125	37	0	3	0	40
4	1255131	20	0	18	0	38
4	1255132	28	0	10	0	38
4	1255154	36	0	7	0	43
4	1255163	42	0	2	0	44
4	1255168	38	0	7	0	45
4	1257070	19	0	18	0	37
4	1257336	20	0	3	0	23
4	1257543	7	0	10	0	17
4	1257984	34	0	2	0	36
4	1260280	7	0	10	0	17
4	1260284	16	0	4	0	20
4	1265107	158	0	254	0	412
4	1267648	9	0	0	0	9
Un_DS483999v1	2471	0	0	0	0	0
Un_DS484083v1	1024	0	0	0	0	0
Un_DS484090v1	1859	0	0	0	0	0
Un_DS484176v1	2586	0	0	0	0	0
Un_DS484511v1	1204	0	0	0	0	0
Un_DS484539v1	1135	0	0	0	0	0
Un_DS484746v1	578	0	0	0	0	0
Un_DS485536v1	813	0	0	0	0	0
Un_DS485605v1	551	0	0	0	0	0
X	514252	0	50	0	50	100
X	514297	0	17	0	77	94
X	514298	0	26	0	70	96
X	516944	0	8	0	72	80
X	516949	0	14	0	67	81
X	516964	0	22	0	58	80
X	923306	0	0	0	87	87
X	923307	0	0	0	86	86
X	924277	0	63	0	45	108
X	1373346	190	0	92	0	282
X	1373528	109	0	128	0	237
X	1373589	146	0	63	0	209
X	1373602	179	0	43	0	222
X	1378095	222	0	87	0	309
X	1378279	157	0	107	0	264
X	1378284	130	0	138	0	268
X	1491577	0	28	0	18	46
X	1676057	0	134	0	10	144
X	1676066	0	49	0	93	142
X	1676597	0	192	0	28	220
X	1690573	0	71	0	136	207
X	1781840	85	1	62	0	148
X	1784005	51	0	78	0	129
X	1784034	59	0	61	0	120
X	1784035	93	0	23	0	116
X	1784036	50	0	67	1	118
X	1785204	154	0	7	0	161
X	1785212	149	0	22	0	171
X	1785216	135	0	37	0	172
X	1785256	136	0	3	0	139
X	1785441	131	0	4	0	135
X	1785444	127	0	8	0	135
X	1785543	112	0	9	0	121
X	1785888	50	0	54	0	104
X	1785903	96	0	14	0	110
X	1786528	133	0	3	0	136
X	1854163	0	0	0	0	0
X	1854164	0	0	0	0	0
X	2078771	0	0	0	69	69
X	2112342	161	0	56	0	217
X	2112355	185	0	27	0	212
X	2112356	158	0	58	0	216
X	2180389	0	0	0	0	0
X	2219688	0	14	0	7	21
X	2376647	0	23	0	14	37
X	2434676	0	4	0	5	9
X	2515228	0	0	0	4	4
X	2625116	1	0	0	0	1
X	2628866	54	0	149	0	203
X	2660761	153	0	0	0	153
X	2667642	1	0	0	0	1
X	2677613	219	0	7	0	226
X	2678338	152	0	10	0	162
X	2678342	113	0	48	0	161
X	3297989	1	0	1	0	2
X	3342781	5	0	5	0	10
X	3343393	49	0	0	0	49
X	3477696	0	0	0	81	81
X	3719089	0	0	0	2	2
X	3730329	0	0	0	0	0
X	3859628	1	445	0	2207	2653
X	3859645	0	674	0	1904	2578
X	3860640	2	399	0	2345	2746
X	3860692	0	366	0	2524	2890
X	3860693	1	1330	0	1535	2866
X	3860694	0	326	0	2573	2899
X	3861312	1	216	1	1728	1946
X	3861498	1	532	3	1849	2385
X	3861499	1	483	6	1848	2338
X	3861500	0	258	1	2157	2416
X	3861501	3	1987	0	330	2320
X	3861505	2	1719	2	603	2326
X	3895378	0	3	0	56	59
X	3953264	212	0	101	0	313
X	4102802	0	0	0	0	0
X	4217290	0	0	0	0	0
X	4352383	7	0	1	0	8
X	4356397	74	0	3	0	77
X	4689184	0	0	1	0	1
X	4689563	0	0	0	0	0
X	4701126	0	0	0	391	391
X	4711852	0	0	0	0	0
X	4981377	0	0	0	0	0
X	5087477	7	0	9	0	16
X	5170349	28	0	3	0	31
X	5239523	82	0	11	0	93
X	5251934	0	0	0	134	134
X	5252342	52	0	33	2	87
X	5360710	3	0	1	0	4
X	5396519	59	0	55	0	114
X	5397332	5	0	14	0	19
X	5397347	17	0	3	0	20
X	5397612	10	0	9	0	19
X	5630114	0	519	0	98	617
X	5630195	0	76	0	659	735
X	5630213	1	363	0	407	771
X	5630234	0	585	0	142	727
X	5630342	0	342	0	312	654
X	5630737	0	54	8	511	573
X	5631026	0	231	1	224	456
X	5631035	0	376	0	71	447
X	5631048	0	398	0	85	483
X	5788690	0	0	17	0	17
X	5810061	0	0	0	0	0
X	5963943	0	0	0	0	0
X	5998043	0	1	0	39	40
X	6105139	0	9	0	129	138
X	6107611	0	136	0	320	456
X	6107620	0	245	0	208	453
X	6107716	0	111	0	47	158
X	6108552	0	299	0	77	376
X	6108553	1	362	0	19	382
X	6108712	0	217	0	7	224
X	6108766	0	93	0	166	259
X	6109871	0	53	0	264	317
X	6112645	0	18	1	180	199
X	6115425	0	230	0	40	270
X	6145386	0	28	0	142	170
X	6184321	0	0	0	0	0
X	6531547	0	0	0	1	1
X	6537186	0	0	11	0	11
X	6577785	7	0	0	0	7
X	6790259	0	1	0	4	5
X	7085816	0	103	0	41	144
X	7445827	16	0	9	0	25
X	7698223	0	0	0	3	3
X	7912801	57	0	0	0	57
X	7938121	1	0	0	0	1
X	7987553	0	0	0	0	0
X	8046474	0	1	0	14	15
X	8055921	0	0	0	0	0
X	8055924	0	0	0	0	0
X	8240090	49	0	129	0	178
X	8240161	125	0	52	0	177
X	8247628	231	0	117	0	348
X	8272518	0	0	0	4	4
X	8403319	10	0	30	0	40
X	8409426	0	0	0	21	21
X	8518112	13	0	1	0	14
X	8632440	0	35	0	33	68
X	8649283	0	1	0	1	2
X	8908884	0	4	0	5	9
X	8910271	0	6	0	0	6
X	8917312	6	0	0	0	6
X	8927652	2	0	0	0	2
X	8927665	1	0	1	0	2
X	8941468	2	0	1	0	3
X	8942088	7	0	0	0	7
X	8942812	6	0	0	0	6
X	8966417	5	0	1	0	6
X	9002119	0	0	0	1	1
X	9020223	26	0	77	0	103
X	9020239	48	0	52	0	100
X	9020384	5	0	73	0	78
X	9022297	0	0	0	123	123
X	9022830	114	0	13	0	127
X	9022835	25	0	99	0	124
X	9022869	13	0	70	0	83
X	9022902	80	0	4	0	84
X	9022931	54	1	61	0	116
X	9022942	69	0	43	0	112
X	9022943	100	0	14	0	114
X	9028080	191	0	100	0	291
X	9028091	176	0	116	0	292
X	9037319	0	1	0	0	1
X	9153487	1	250	0	1728	1979
X	9200948	0	0	0	0	0
X	9278576	0	13	0	19	32
X	9340169	0	0	0	0	0
X	9574655	0	79	0	24	103
X	9754490	1	0	19	0	20
X	10016995	0	0	0	0	0
X	10247964	0	8	0	18	26
X	10330625	0	0	0	0	0
X	10356486	223	0	0	0	223
X	10463690	67	0	0	0	67
X	10639732	0	0	0	0	0
X	10709480	64	0	12	0	76
X	10711327	0	0	0	30	30
X	10711351	0	0	0	31	31
X	10746485	127	1	52	0	180
X	10746488	105	0	70	0	175
X	10817179	0	0	0	0	0
X	10835849	0	53	0	26	79
X	10846781	0	53	0	51	104
X	11047667	18	0	7	0	25
X	11047679	20	0	4	0	24
X	11047750	11	0	19	0	30
X	11047753	10	0	18	0	28
X	11048103	5	0	15	0	20
X	11052798	0	221	0	142	363
X	11221249	0	2	0	45	47
X	11221253	0	4	0	43	47
X	11221255	0	2	0	45	47
X	11221259	0	7	0	42	49
X	11221261	0	2	0	48	50
X	11221263	0	2	0	47	49
X	11221265	0	1	0	46	47
X	11221267	0	1	0	46	47
X	11221296	0	2	0	47	49
X	11221308	0	3	0	45	48
X	11221310	0	0	0	47	47
X	11221312	0	0	0	46	46
X	11221318	0	4	0	42	46
X	11221322	1	0	0	45	46
X	11221325	0	11	0	36	47
X	11224387	0	27	0	28	55
X	11330935	83	0	0	0	83
X	11371626	3	0	4	0	7
X	11553315	118	0	1	0	119
X	11575555	6	0	13	0	19
X	11704179	133	0	46	0	179
X	11704188	97	0	63	0	160
X	11812074	0	59	0	56	115
X	11812089	0	69	0	56	125
X	11939698	0	64	0	81	145
X	11939764	0	49	0	91	140
X	11949882	0	73	0	70	143
X	11949883	0	34	0	112	146
X	11954277	0	86	0	28	114
X	11955525	1	12	0	9	22
X	11955561	0	18	0	6	24
X	11964192	0	9	0	69	78
X	11967712	0	21	0	18	39
X	11968032	0	16	0	8	24
X	11968676	0	9	0	100	109
X	11968768	0	63	0	43	106
X	11968969	0	34	0	75	109
X	11970546	0	22	0	78	100
X	11970552	1	7	0	85	93
X	11970556	0	38	0	67	105
X	11971853	0	58	0	29	87
X	11977538	0	60	0	18	78
X	12178407	0	0	0	0	0
X	12234654	0	0	0	0	0
X	12321994	0	0	154	0	154
X	12411368	0	0	0	0	0
X	12446818	40	0	6	0	46
X	12517682	0	18	0	40	58
X	12517716	0	10	0	52	62
X	12530707	0	0	0	1	1
X	12570094	0	8	0	15	23
X	12570147	0	15	0	9	24
X	12610058	0	1	0	71	72
X	12633103	4	0	8	0	12
X	12638680	344	0	62	0	406
X	12670776	0	0	0	0	0
X	12772709	26	0	8	1	35
X	12779207	0	2	0	7	9
X	12836423	0	0	0	0	0
X	12920895	8	0	1	0	9
X	13075382	28	0	96	0	124
X	13326657	0	0	68	0	68
X	13338794	42	0	0	0	42
X	13363027	0	0	1	0	1
X	13363147	1	0	4	0	5
X	13364994	37	0	18	0	55
X	13375332	0	0	6	0	6
X	13713539	62	0	8	0	70
X	13713540	60	0	11	0	71
X	13713557	73	0	8	0	81
X	13713560	71	0	7	0	78
X	13713989	25	0	10	0	35
X	13714028	42	0	1	0	43
X	13714030	33	0	11	0	44
X	13714099	40	0	1	0	41
X	13714108	37	0	5	0	42
X	13915030	0	0	0	0	0
X	13960364	0	0	0	2	2
X	13981405	0	0	0	0	0
X	13988603	0	3	0	10	13
X	14017285	0	0	0	0	0
X	14272086	82	0	34	0	116
X	14272092	6	0	107	0	113
X	14272096	3	0	116	0	119
X	14274268	81	0	43	0	124
X	14791453	0	48	0	104	152
X	14803625	0	0	0	2	2
X	14827027	0	10	0	51	61
X	14827028	0	22	0	38	60
X	14827029	0	28	0	38	66
X	14904567	856	0	0	0	856
X	14932507	48	0	15	0	63
X	14996674	34	0	39	0	73
X	14999166	6	0	10	0	16
X	14999641	14	0	9	0	23
X	14999868	7	0	72	0	79
X	14999920	87	0	16	0	103
X	14999924	12	0	91	0	103
X	14999938	76	0	11	0	87
X	15000623	21	0	67	0	88
X	15002265	23	0	32	0	55
X	15004413	25	0	82	0	107
X	15004776	11	0	66	0	77
X	15004857	30	0	88	0	118
X	15004878	83	0	39	0	122
X	15043300	0	0	0	0	0
X	15058391	0	37	0	8	45
X	15098493	81	0	83	0	164
X	15098592	61	1	113	0	175
X	15111879	45	0	94	0	139
X	15112038	68	0	4	0	72
X	15304670	2	0	0	0	2
X	15388627	1	11	0	54	66
X	15392685	0	130	0	25	155
X	15483634	38	0	3	0	41
X	15484167	21	0	1	0	22
X	15501741	1	0	1	0	2
X	15531613	0	0	0	0	0
X	15581889	0	22	0	0	22
X	15897294	388	0	358	0	746
X	15897759	33	1	20	0	54
X	15897789	44	0	1	0	45
X	15897854	34	0	6	0	40
X	15897856	39	0	4	0	43
X	15903965	30	1	143	0	174
X	15919889	105	0	11	0	116
X	15952334	0	12	0	19	31
X	15956689	0	9	0	44	53
X	15956841	0	1	0	55	56
X	15958587	0	159	0	13	172
X	15961105	0	0	0	27	27
X	15961636	0	2	0	28	30
X	15989371	1	4	0	52	57
X	16075853	0	1	0	86	87
X	16339624	66	0	68	0	134
X	16339799	76	0	9	0	85
X	16456420	0	8	0	70	78
X	16456425	0	25	0	50	75
X	16460238	0	18	0	103	121
X	16460589	0	17	0	129	146
X	16460590	0	5	0	142	147
X	16460595	0	17	0	129	146
X	16464719	0	120	0	16	136
X	16466198	0	30	0	22	52
X	16466199	0	43	0	8	51
X	16466203	0	10	0	38	48
X	16466204	0	10	0	38	48
X	16466216	0	3	0	43	46
X	16466692	0	0	0	118	118
X	16468562	0	73	0	3	76
X	16469630	0	23	0	41	64
X	16469631	0	31	0	32	63
X	16471229	0	58	0	39	97
X	16471265	0	41	0	66	107
X	16471290	0	16	0	88	104
X	16471319	0	29	0	61	90
X	16471811	0	23	0	21	44
X	16471812	0	14	0	29	43
X	16471813	0	21	0	25	46
X	16471814	0	19	0	25	44
X	16473609	0	6	0	61	67
X	16473610	0	6	0	58	64
X	16473637	0	36	0	20	56
X	16473638	0	2	0	57	59
X	16475638	0	14	0	85	99
X	16475685	0	6	0	93	99
X	16477558	0	14	0	79	93
X	16481881	0	6	0	20	26
X	16482682	0	66	0	47	113
X	16482683	0	39	0	80	119
X	16482692	0	2	0	116	118
X	16482693	0	68	0	49	117
X	16504240	0	60	0	56	116
X	16504273	0	0	0	120	120
X	16505310	0	3	0	21	24
X	16505550	0	92	1	38	131
X	16509658	0	11	0	121	132
X	16509671	0	11	0	125	136
X	16509684	0	18	0	111	129
X	16511854	0	1	0	16	17
X	16514487	0	5	0	24	29
X	16517164	0	20	0	15	35
X	16518833	0	76	0	28	104
X	16523520	0	0	0	1	1
X	16523529	0	0	0	1	1
X	16523541	0	0	0	1	1
X	16523553	0	0	0	1	1
X	16523556	0	0	0	1	1
X	16523557	0	0	0	0	0
X	16532860	0	3	0	6	9
X	16532866	0	3	0	6	9
X	16562027	0	24	0	111	135
X	16562108	0	25	0	103	128
X	16681534	0	4	0	33	37
X	16839820	0	13	0	38	51
X	16839947	0	4	0	62	66
X	16905030	0	0	0	1	1
X	16915290	7	0	0	0	7
X	17016883	0	2	0	6	8
X	17016898	0	0	0	8	8
X	17017015	0	3	0	2	5
X	17027613	0	0	0	0	0
X	17082644	0	0	0	0	0
X	17097065	53	0	4	0	57
X	17291667	0	0	0	0	0
X	17666685	617	0	0	0	617
X	17674476	0	3	0	10	13
X	17926624	0	73	0	44	117
X	17930651	0	124	0	40	164
X	17930658	0	148	0	13	161
X	17930733	0	88	0	74	162
X	17930890	0	69	0	13	82
X	17930948	2	38	0	38	78
X	17936502	0	8	0	45	53
X	17938011	0	0	1	230	231
X	17941537	0	6	0	34	40
X	17941569	0	2	0	32	34
X	17941570	0	1	0	32	33
X	17942236	0	1	0	47	48
X	17945833	0	4	0	26	30
X	17950057	0	46	0	304	350
X	17952716	0	16	0	314	330
X	17952717	0	16	0	311	327
X	17961411	0	4	0	1	5
X	17981650	0	20	0	39	59
X	17982144	0	48	0	20	68
X	17983811	0	32	0	60	92
X	17983847	0	58	0	11	69
X	17987714	0	3	0	54	57
X	17987788	0	17	0	57	74
X	17987790	0	41	0	35	76
X	17987796	0	23	0	47	70
X	17988376	0	2	0	18	20
X	17989432	0	8	0	52	60
X	17989433	0	48	0	11	59
X	17991679	0	0	0	0	0
X	17991684	0	0	0	0	0
X	17991689	0	0	0	0	0
X	17991690	0	0	0	0	0
X	17991691	0	0	0	0	0
X	18107572	0	0	0	21	21
X	18107970	0	2	0	18	20
X	18170126	21	0	52	0	73
X	18172085	119	0	0	0	119
X	18172108	106	0	0	0	106
X	18173979	94	0	7	0	101
X	18174020	79	0	9	0	88
X	18174056	69	0	8	0	77
X	18177807	6	0	0	0	6
X	18201429	97	0	11	0	108
X	18558815	8	0	0	0	8
X	18901523	5	0	0	0	5
X	19153046	0	0	0	68	68
X	19265115	6	0	23	0	29
X	19265410	0	0	4	0	4
X	19283881	0	27	1	50	78
X	19334465	0	100	0	15	115
X	19334522	0	28	0	75	103
X	19341081	0	8	0	58	66
X	19341084	0	6	0	58	64
X	19341882	0	5	0	131	136
X	19342007	0	79	0	55	134
X	19508447	308	0	56	0	364
X	19545747	0	0	0	2	2
X	19641588	0	41	0	77	118
X	19651650	0	0	0	18	18
X	19727697	14	0	99	0	113
X	19727698	9	0	103	0	112
X	19831888	0	3	0	18	21
X	19835017	0	12	0	19	31
X	19857622	32	0	0	0	32
X	19888186	0	0	1	0	1
X	20330037	0	0	0	1	1
X	20330041	0	0	0	1	1
X	20770084	0	21	0	18	39
X	20773442	0	25	0	12	37
X	20819626	0	0	0	0	0
X	20828303	0	0	0	3	3
X	20828316	0	1	0	2	3
X	20828348	0	3	0	0	3
X	20828364	0	2	0	0	2
X	20828369	0	2	0	0	2
X	20828370	0	1	0	1	2
X	20923843	0	17	0	21	38
X	20924823	0	1	0	2	3
X	21068672	0	1	0	0	1
X	21304740	0	0	0	0	0
X	21629428	0	147	0	184	331
X	21629453	1	120	0	214	335
X	21629508	0	58	0	265	323
X	21629725	0	213	0	132	345
X	21629726	0	148	0	204	352
X	21629727	0	131	0	220	351
X	21629737	0	209	0	149	358
X	22489005	5	0	5	0	10
X	22489022	10	0	0	0	10
X	22499716	52	0	13	0	65
X	22499717	33	0	32	0	65
X	22499732	21	0	52	0	73
X	22502642	277	0	40	0	317
X	22502713	80	0	216	0	296
X	22502735	229	0	60	0	289
X	22980987	0	11	0	225	236
X	22982709	0	459	0	239	698
X	22983936	0	14	0	5	19
X	22984239	0	17	0	18	35
X	22984267	0	3	1	36	40
X	22984352	0	6	0	44	50
X	23024266	1	0	2	0	3
X	23029207	6	0	0	0	6
X	23206974	0	0	0	0	0
Y	400261	0	0	0	0	0
Y	688072	0	0	0	0	0
Y_CP007107v1_random	40134	0	0	0	0	0
Y_DS485767v1_random	101	0	0	0	0	0
